CATTTCGTTTA -> ATTTCGTTTAC
ATTTCGTTTAC -> TTTCGTTTACG
TTTCGTTTACG -> TTCGTTTACGG
TTCGTTTACGG -> TCGTTTACGGA
TCGTTTACGGA -> CGTTTACGGAA, CGTTTACGGAC
CGTTTACGGAA -> GTTTACGGAAT
GTTTACGGAAT -> TTTACGGAATA
TTTACGGAATA -> TTACGGAATAA
TTACGGAATAA -> TACGGAATAAG
TACGGAATAAG -> ACGGAATAAGC
ACGGAATAAGC -> CGGAATAAGCT
CGGAATAAGCT -> GGAATAAGCTA
GGAATAAGCTA -> GAATAAGCTAT
GAATAAGCTAT -> AATAAGCTATC
AATAAGCTATC -> ATAAGCTATCT
ATAAGCTATCT -> TAAGCTATCTT
TAAGCTATCTT -> AAGCTATCTTC
AAGCTATCTTC -> AGCTATCTTCT
AGCTATCTTCT -> GCTATCTTCTA
GCTATCTTCTA -> CTATCTTCTAC
CTATCTTCTAC -> TATCTTCTACA
TATCTTCTACA -> ATCTTCTACAT
ATCTTCTACAT -> TCTTCTACATC
TCTTCTACATC -> CTTCTACATCT
CTTCTACATCT -> TTCTACATCTT
TTCTACATCTT -> TCTACATCTTG
TCTACATCTTG -> CTACATCTTGC
CTACATCTTGC -> TACATCTTGCC
TACATCTTGCC -> ACATCTTGCCG
ACATCTTGCCG -> CATCTTGCCGT
CATCTTGCCGT -> ATCTTGCCGTT
ATCTTGCCGTT -> TCTTGCCGTTG
TCTTGCCGTTG -> CTTGCCGTTGT
CTTGCCGTTGT -> TTGCCGTTGTT
TTGCCGTTGTT -> TGCCGTTGTTC
TGCCGTTGTTC -> GCCGTTGTTCG
GCCGTTGTTCG -> CCGTTGTTCGT
CCGTTGTTCGT -> CGTTGTTCGTG
CGTTGTTCGTG -> GTTGTTCGTGG
GTTGTTCGTGG -> TTGTTCGTGGA
TTGTTCGTGGA -> TGTTCGTGGAG
TGTTCGTGGAG -> GTTCGTGGAGT
GTTCGTGGAGT -> TTCGTGGAGTG
TTCGTGGAGTG -> TCGTGGAGTGA
TCGTGGAGTGA -> CGTGGAGTGAA
CGTGGAGTGAA -> GTGGAGTGAAG
GTGGAGTGAAG -> TGGAGTGAAGA
TGGAGTGAAGA -> GGAGTGAAGAT
GGAGTGAAGAT -> GAGTGAAGATC
GAGTGAAGATC -> AGTGAAGATCG
AGTGAAGATCG -> GTGAAGATCGC
GTGAAGATCGC -> TGAAGATCGCC
TGAAGATCGCC -> GAAGATCGCCC
GAAGATCGCCC -> AAGATCGCCCC
AAGATCGCCCC -> AGATCGCCCCG
AGATCGCCCCG -> GATCGCCCCGC
GATCGCCCCGC -> ATCGCCCCGCC
ATCGCCCCGCC -> TCGCCCCGCCC
TCGCCCCGCCC -> CGCCCCGCCCG
CGCCCCGCCCG -> GCCCCGCCCGT
GCCCCGCCCGT -> CCCCGCCCGTC
CCCCGCCCGTC -> CCCGCCCGTCC
CCCGCCCGTCC -> CCGCCCGTCCC
CCGCCCGTCCC -> CGCCCGTCCCT
CGCCCGTCCCT -> GCCCGTCCCTC
GCCCGTCCCTC -> CCCGTCCCTCG
CCCGTCCCTCG -> CCGTCCCTCGT
CCGTCCCTCGT -> CGTCCCTCGTT
CGTCCCTCGTT -> GTCCCTCGTTT
GTCCCTCGTTT -> TCCCTCGTTTA
TCCCTCGTTTA -> CCCTCGTTTAC
CCCTCGTTTAC -> CCTCGTTTACG
CCTCGTTTACG -> CTCGTTTACGG
CTCGTTTACGG -> TCGTTTACGGA
CGTTTACGGAC -> GTTTACGGACG
GTTTACGGACG -> TTTACGGACGT
TTTACGGACGT -> TTACGGACGTC
TTACGGACGTC -> TACGGACGTCA
TACGGACGTCA -> ACGGACGTCAA
ACGGACGTCAA -> CGGACGTCAAT
CGGACGTCAAT -> GGACGTCAATT
GGACGTCAATT -> GACGTCAATTT
GACGTCAATTT -> ACGTCAATTTC
ACGTCAATTTC -> CGTCAATTTCA
CGTCAATTTCA -> GTCAATTTCAA
GTCAATTTCAA -> TCAATTTCAAG
TCAATTTCAAG -> CAATTTCAAGT
CAATTTCAAGT -> AATTTCAAGTG
AATTTCAAGTG -> ATTTCAAGTGG
ATTTCAAGTGG -> TTTCAAGTGGA
TTTCAAGTGGA -> TTCAAGTGGAA
TTCAAGTGGAA -> TCAAGTGGAAA
TCAAGTGGAAA -> CAAGTGGAAAC
CAAGTGGAAAC -> AAGTGGAAACG
AAGTGGAAACG -> AGTGGAAACGA
AGTGGAAACGA -> GTGGAAACGAG
GTGGAAACGAG -> TGGAAACGAGC
TGGAAACGAGC -> GGAAACGAGCC
GGAAACGAGCC -> GAAACGAGCCC
GAAACGAGCCC -> AAACGAGCCCA
AAACGAGCCCA -> AACGAGCCCAT
AACGAGCCCAT -> ACGAGCCCATG
ACGAGCCCATG -> CGAGCCCATGT
CGAGCCCATGT -> GAGCCCATGTG
GAGCCCATGTG -> AGCCCATGTGC
AGCCCATGTGC -> GCCCATGTGCG
GCCCATGTGCG -> CCCATGTGCGA
CCCATGTGCGA -> CCATGTGCGAG
CCATGTGCGAG -> CATGTGCGAGT
CATGTGCGAGT -> ATGTGCGAGTC
ATGTGCGAGTC -> TGTGCGAGTCC
TGTGCGAGTCC -> GTGCGAGTCCT
GTGCGAGTCCT -> TGCGAGTCCTG
TGCGAGTCCTG -> GCGAGTCCTGA
GCGAGTCCTGA -> CGAGTCCTGAC
CGAGTCCTGAC -> GAGTCCTGACT
GAGTCCTGACT -> AGTCCTGACTG
AGTCCTGACTG -> GTCCTGACTGT
GTCCTGACTGT -> TCCTGACTGTG
TCCTGACTGTG -> CCTGACTGTGG
CCTGACTGTGG -> CTGACTGTGGA
CTGACTGTGGA -> TGACTGTGGAC
TGACTGTGGAC -> GACTGTGGACT
GACTGTGGACT -> ACTGTGGACTG
ACTGTGGACTG -> CTGTGGACTGT
CTGTGGACTGT -> TGTGGACTGTC
TGTGGACTGTC -> GTGGACTGTCT
GTGGACTGTCT -> TGGACTGTCTT
TGGACTGTCTT -> GGACTGTCTTC
GGACTGTCTTC -> GACTGTCTTCA
GACTGTCTTCA -> ACTGTCTTCAT
ACTGTCTTCAT -> CTGTCTTCATT
CTGTCTTCATT -> TGTCTTCATTG
TGTCTTCATTG -> GTCTTCATTGC
GTCTTCATTGC -> TCTTCATTGCC
TCTTCATTGCC -> CTTCATTGCCT
CTTCATTGCCT -> TTCATTGCCTC
TTCATTGCCTC -> TCATTGCCTCT
TCATTGCCTCT -> CATTGCCTCTG
CATTGCCTCTG -> ATTGCCTCTGG
ATTGCCTCTGG -> TTGCCTCTGGC
TTGCCTCTGGC -> TGCCTCTGGCA
TGCCTCTGGCA -> GCCTCTGGCAT
GCCTCTGGCAT -> CCTCTGGCATG
CCTCTGGCATG -> CTCTGGCATGT
CTCTGGCATGT -> TCTGGCATGTG
TCTGGCATGTG -> CTGGCATGTGT
CTGGCATGTGT -> TGGCATGTGTT
TGGCATGTGTT -> GGCATGTGTTT
GGCATGTGTTT -> GCATGTGTTTT
GCATGTGTTTT -> CATGTGTTTTC
CATGTGTTTTC -> ATGTGTTTTCT
ATGTGTTTTCT -> TGTGTTTTCTA
TGTGTTTTCTA -> GTGTTTTCTAG
GTGTTTTCTAG -> TGTTTTCTAGT
TGTTTTCTAGT -> GTTTTCTAGTA
GTTTTCTAGTA -> TTTTCTAGTAT
TTTTCTAGTAT -> TTTCTAGTATC
TTTCTAGTATC -> TTCTAGTATCG
TTCTAGTATCG -> TCTAGTATCGG
TCTAGTATCGG -> CTAGTATCGGG
CTAGTATCGGG -> TAGTATCGGGG
TAGTATCGGGG -> AGTATCGGGGC
AGTATCGGGGC -> GTATCGGGGCA
GTATCGGGGCA -> TATCGGGGCAC
TATCGGGGCAC -> ATCGGGGCACT
ATCGGGGCACT -> TCGGGGCACTT
TCGGGGCACTT -> CGGGGCACTTT
CGGGGCACTTT -> GGGGCACTTTG
GGGGCACTTTG -> GGGCACTTTGT
GGGCACTTTGT -> GGCACTTTGTC
GGCACTTTGTC -> GCACTTTGTCT
GCACTTTGTCT -> CACTTTGTCTT
CACTTTGTCTT -> ACTTTGTCTTT
ACTTTGTCTTT -> CTTTGTCTTTC
CTTTGTCTTTC -> TTTGTCTTTCG
TTTGTCTTTCG -> TTGTCTTTCGG
TTGTCTTTCGG -> TGTCTTTCGGG
TGTCTTTCGGG -> GTCTTTCGGGT
GTCTTTCGGGT -> TCTTTCGGGTT
TCTTTCGGGTT -> CTTTCGGGTTA
CTTTCGGGTTA -> TTTCGGGTTAC
TTTCGGGTTAC -> TTCGGGTTACT
TTCGGGTTACT -> TCGGGTTACTA
TCGGGTTACTA -> CGGGTTACTAT
CGGGTTACTAT -> GGGTTACTATT
GGGTTACTATT -> GGTTACTATTC
GGTTACTATTC -> GTTACTATTCT
GTTACTATTCT -> TTACTATTCTT
TTACTATTCTT -> TACTATTCTTA
TACTATTCTTA -> ACTATTCTTAT
ACTATTCTTAT -> CTATTCTTATC
CTATTCTTATC -> TATTCTTATCA
TATTCTTATCA -> ATTCTTATCAA
ATTCTTATCAA -> TTCTTATCAAT
TTCTTATCAAT -> TCTTATCAATT
TCTTATCAATT -> CTTATCAATTC
CTTATCAATTC -> TTATCAATTCT
TTATCAATTCT -> TATCAATTCTG
TATCAATTCTG -> ATCAATTCTGA
ATCAATTCTGA -> TCAATTCTGAG
TCAATTCTGAG -> CAATTCTGAGC
CAATTCTGAGC -> AATTCTGAGCT
AATTCTGAGCT -> ATTCTGAGCTC
ATTCTGAGCTC -> TTCTGAGCTCC
TTCTGAGCTCC -> TCTGAGCTCCA
TCTGAGCTCCA -> CTGAGCTCCAC
CTGAGCTCCAC -> TGAGCTCCACT
TGAGCTCCACT -> GAGCTCCACTG
GAGCTCCACTG -> AGCTCCACTGA
AGCTCCACTGA -> GCTCCACTGAG
GCTCCACTGAG -> CTCCACTGAGT
CTCCACTGAGT -> TCCACTGAGTC
TCCACTGAGTC -> CCACTGAGTCA
CCACTGAGTCA -> CACTGAGTCAA
CACTGAGTCAA -> ACTGAGTCAAA
ACTGAGTCAAA -> CTGAGTCAAAC
CTGAGTCAAAC -> TGAGTCAAACC
TGAGTCAAACC -> GAGTCAAACCG
GAGTCAAACCG -> AGTCAAACCGG
AGTCAAACCGG -> GTCAAACCGGC
GTCAAACCGGC -> TCAAACCGGCC
TCAAACCGGCC -> CAAACCGGCCG
CAAACCGGCCG -> AAACCGGCCGA
AAACCGGCCGA -> AACCGGCCGAC
AACCGGCCGAC -> ACCGGCCGACT
ACCGGCCGACT -> CCGGCCGACTA
CCGGCCGACTA -> CGGCCGACTAC
CGGCCGACTAC -> GGCCGACTACT
GGCCGACTACT -> GCCGACTACTA
GCCGACTACTA -> CCGACTACTAT
CCGACTACTAT -> CGACTACTATC
CGACTACTATC -> GACTACTATCG
GACTACTATCG -> ACTACTATCGC
ACTACTATCGC -> CTACTATCGCT
CTACTATCGCT -> TACTATCGCTG
TACTATCGCTG -> ACTATCGCTGG
ACTATCGCTGG -> CTATCGCTGGT
CTATCGCTGGT -> TATCGCTGGTA
TATCGCTGGTA -> ATCGCTGGTAA
ATCGCTGGTAA -> TCGCTGGTAAG
TCGCTGGTAAG -> CGCTGGTAAGA
CGCTGGTAAGA -> GCTGGTAAGAG
GCTGGTAAGAG -> CTGGTAAGAGA
CTGGTAAGAGA -> TGGTAAGAGAT
TGGTAAGAGAT -> GGTAAGAGATT
GGTAAGAGATT -> GTAAGAGATTG
GTAAGAGATTG -> TAAGAGATTGG
TAAGAGATTGG -> AAGAGATTGGT
AAGAGATTGGT -> AGAGATTGGTT
AGAGATTGGTT -> GAGATTGGTTA
GAGATTGGTTA -> AGATTGGTTAC
AGATTGGTTAC -> GATTGGTTACA
GATTGGTTACA -> ATTGGTTACAT
ATTGGTTACAT -> TTGGTTACATT
TTGGTTACATT -> TGGTTACATTC
TGGTTACATTC -> GGTTACATTCT
GGTTACATTCT -> GTTACATTCTA
GTTACATTCTA -> TTACATTCTAG
TTACATTCTAG -> TACATTCTAGT
TACATTCTAGT -> ACATTCTAGTG
ACATTCTAGTG -> CATTCTAGTGT
CATTCTAGTGT -> ATTCTAGTGTG
ATTCTAGTGTG -> TTCTAGTGTGG
TTCTAGTGTGG -> TCTAGTGTGGA
TCTAGTGTGGA -> CTAGTGTGGAG
CTAGTGTGGAG -> TAGTGTGGAGA
TAGTGTGGAGA -> AGTGTGGAGAG
AGTGTGGAGAG -> GTGTGGAGAGG
GTGTGGAGAGG -> TGTGGAGAGGG
TGTGGAGAGGG -> GTGGAGAGGGC
GTGGAGAGGGC -> TGGAGAGGGCT
TGGAGAGGGCT -> GGAGAGGGCTG
GGAGAGGGCTG -> GAGAGGGCTGT
GAGAGGGCTGT -> AGAGGGCTGTG
AGAGGGCTGTG -> GAGGGCTGTGG
GAGGGCTGTGG -> AGGGCTGTGGT
AGGGCTGTGGT -> GGGCTGTGGTG
GGGCTGTGGTG -> GGCTGTGGTGA
GGCTGTGGTGA -> GCTGTGGTGAC
GCTGTGGTGAC -> CTGTGGTGACT
CTGTGGTGACT -> TGTGGTGACTA
TGTGGTGACTA -> GTGGTGACTAT
GTGGTGACTAT -> TGGTGACTATG
TGGTGACTATG -> GGTGACTATGC
GGTGACTATGC -> GTGACTATGCA
GTGACTATGCA -> TGACTATGCAC
TGACTATGCAC -> GACTATGCACG
GACTATGCACG -> ACTATGCACGC
ACTATGCACGC -> CTATGCACGCC
CTATGCACGCC -> TATGCACGCCG
TATGCACGCCG -> ATGCACGCCGT
ATGCACGCCGT -> TGCACGCCGTG
TGCACGCCGTG -> GCACGCCGTGA
GCACGCCGTGA -> CACGCCGTGAC
CACGCCGTGAC -> ACGCCGTGACA
ACGCCGTGACA -> CGCCGTGACAA
CGCCGTGACAA -> GCCGTGACAAG
GCCGTGACAAG -> CCGTGACAAGT
CCGTGACAAGT -> CGTGACAAGTT
CGTGACAAGTT -> GTGACAAGTTG
GTGACAAGTTG -> TGACAAGTTGA
TGACAAGTTGA -> GACAAGTTGAA
GACAAGTTGAA -> ACAAGTTGAAC
ACAAGTTGAAC -> CAAGTTGAACA
CAAGTTGAACA -> AAGTTGAACAA
AAGTTGAACAA -> AGTTGAACAAC
AGTTGAACAAC -> GTTGAACAACG
GTTGAACAACG -> TTGAACAACGC
TTGAACAACGC -> TGAACAACGCC
TGAACAACGCC -> GAACAACGCCA
GAACAACGCCA -> AACAACGCCAC
AACAACGCCAC -> ACAACGCCACC
ACAACGCCACC -> CAACGCCACCA
CAACGCCACCA -> AACGCCACCAA
AACGCCACCAA -> ACGCCACCAAT
ACGCCACCAAT -> CGCCACCAATT
CGCCACCAATT -> GCCACCAATTA
GCCACCAATTA -> CCACCAATTAA
CCACCAATTAA -> CACCAATTAAT
CACCAATTAAT -> ACCAATTAATA
ACCAATTAATA -> CCAATTAATAG
CCAATTAATAG -> CAATTAATAGT
CAATTAATAGT -> AATTAATAGTG
AATTAATAGTG -> ATTAATAGTGG
ATTAATAGTGG -> TTAATAGTGGC
TTAATAGTGGC -> TAATAGTGGCT
TAATAGTGGCT -> AATAGTGGCTC
AATAGTGGCTC -> ATAGTGGCTCG
ATAGTGGCTCG -> TAGTGGCTCGA
TAGTGGCTCGA -> AGTGGCTCGAG
AGTGGCTCGAG -> GTGGCTCGAGG
GTGGCTCGAGG -> TGGCTCGAGGA
TGGCTCGAGGA -> GGCTCGAGGAG
GGCTCGAGGAG -> GCTCGAGGAGG
GCTCGAGGAGG -> CTCGAGGAGGC
CTCGAGGAGGC -> TCGAGGAGGCG
TCGAGGAGGCG -> CGAGGAGGCGT
CGAGGAGGCGT -> GAGGAGGCGTC
GAGGAGGCGTC -> AGGAGGCGTCT
AGGAGGCGTCT -> GGAGGCGTCTC
GGAGGCGTCTC -> GAGGCGTCTCA
GAGGCGTCTCA -> AGGCGTCTCAA
AGGCGTCTCAA -> GGCGTCTCAAC
GGCGTCTCAAC -> GCGTCTCAACA
GCGTCTCAACA -> CGTCTCAACAG
CGTCTCAACAG -> GTCTCAACAGA
GTCTCAACAGA -> TCTCAACAGAA
TCTCAACAGAA -> CTCAACAGAAC
CTCAACAGAAC -> TCAACAGAACA
TCAACAGAACA -> CAACAGAACAT
CAACAGAACAT -> AACAGAACATT
AACAGAACATT -> ACAGAACATTT
ACAGAACATTT -> CAGAACATTTA
CAGAACATTTA -> AGAACATTTAG
AGAACATTTAG -> GAACATTTAGC
GAACATTTAGC -> AACATTTAGCA
AACATTTAGCA -> ACATTTAGCAG
ACATTTAGCAG -> CATTTAGCAGG
CATTTAGCAGG -> ATTTAGCAGGG
ATTTAGCAGGG -> TTTAGCAGGGG
TTTAGCAGGGG -> TTAGCAGGGGA
TTAGCAGGGGA -> TAGCAGGGGAT
TAGCAGGGGAT -> AGCAGGGGATA
AGCAGGGGATA -> GCAGGGGATAT
GCAGGGGATAT -> CAGGGGATATA
CAGGGGATATA -> AGGGGATATAA
AGGGGATATAA -> GGGGATATAAC
GGGGATATAAC -> GGGATATAACC
GGGATATAACC -> GGATATAACCA
GGATATAACCA -> GATATAACCAC
GATATAACCAC -> ATATAACCACT
ATATAACCACT -> TATAACCACTC
TATAACCACTC -> ATAACCACTCT
ATAACCACTCT -> TAACCACTCTC
TAACCACTCTC -> AACCACTCTCA
AACCACTCTCA -> ACCACTCTCAC
ACCACTCTCAC -> CCACTCTCACG
CCACTCTCACG -> CACTCTCACGT
CACTCTCACGT -> ACTCTCACGTT
ACTCTCACGTT -> CTCTCACGTTC
CTCTCACGTTC -> TCTCACGTTCC
TCTCACGTTCC -> CTCACGTTCCG
CTCACGTTCCG -> TCACGTTCCGT
TCACGTTCCGT -> CACGTTCCGTG
CACGTTCCGTG -> ACGTTCCGTGT
ACGTTCCGTGT -> CGTTCCGTGTA
CGTTCCGTGTA -> GTTCCGTGTAA
GTTCCGTGTAA -> TTCCGTGTAAG
TTCCGTGTAAG -> TCCGTGTAAGA
TCCGTGTAAGA -> CCGTGTAAGAG
CCGTGTAAGAG -> CGTGTAAGAGG
CGTGTAAGAGG -> GTGTAAGAGGG
GTGTAAGAGGG -> TGTAAGAGGGC
TGTAAGAGGGC -> GTAAGAGGGCG
GTAAGAGGGCG -> TAAGAGGGCGC
TAAGAGGGCGC -> AAGAGGGCGCG
AAGAGGGCGCG -> AGAGGGCGCGA
AGAGGGCGCGA -> GAGGGCGCGAG
GAGGGCGCGAG -> AGGGCGCGAGT
AGGGCGCGAGT -> GGGCGCGAGTC
GGGCGCGAGTC -> GGCGCGAGTCC
GGCGCGAGTCC -> GCGCGAGTCCG
GCGCGAGTCCG -> CGCGAGTCCGG
CGCGAGTCCGG -> GCGAGTCCGGA
GCGAGTCCGGA -> CGAGTCCGGAG
CGAGTCCGGAG -> GAGTCCGGAGA
GAGTCCGGAGA -> AGTCCGGAGAC
AGTCCGGAGAC -> GTCCGGAGACT
GTCCGGAGACT -> TCCGGAGACTG
TCCGGAGACTG -> CCGGAGACTGT
CCGGAGACTGT -> CGGAGACTGTT
CGGAGACTGTT -> GGAGACTGTTT
GGAGACTGTTT -> GAGACTGTTTT
GAGACTGTTTT -> AGACTGTTTTG
AGACTGTTTTG -> GACTGTTTTGC
GACTGTTTTGC -> ACTGTTTTGCA
ACTGTTTTGCA -> CTGTTTTGCAC
CTGTTTTGCAC -> TGTTTTGCACC
TGTTTTGCACC -> GTTTTGCACCC
GTTTTGCACCC -> TTTTGCACCCG
TTTTGCACCCG -> TTTGCACCCGG
TTTGCACCCGG -> TTGCACCCGGC
TTGCACCCGGC -> TGCACCCGGCC
TGCACCCGGCC -> GCACCCGGCCG
GCACCCGGCCG -> CACCCGGCCGG
CACCCGGCCGG -> ACCCGGCCGGT
ACCCGGCCGGT -> CCCGGCCGGTT
CCCGGCCGGTT -> CCGGCCGGTTA
CCGGCCGGTTA -> CGGCCGGTTAT
CGGCCGGTTAT -> GGCCGGTTATT
GGCCGGTTATT -> GCCGGTTATTC
GCCGGTTATTC -> CCGGTTATTCC
CCGGTTATTCC -> CGGTTATTCCG
CGGTTATTCCG -> GGTTATTCCGG
GGTTATTCCGG -> GTTATTCCGGT
GTTATTCCGGT -> TTATTCCGGTT
TTATTCCGGTT -> TATTCCGGTTC
TATTCCGGTTC -> ATTCCGGTTCC
ATTCCGGTTCC -> TTCCGGTTCCC
TTCCGGTTCCC -> TCCGGTTCCCC
TCCGGTTCCCC -> CCGGTTCCCCA
CCGGTTCCCCA -> CGGTTCCCCAA
CGGTTCCCCAA -> GGTTCCCCAAA
GGTTCCCCAAA -> GTTCCCCAAAA
GTTCCCCAAAA -> TTCCCCAAAAG
TTCCCCAAAAG -> TCCCCAAAAGC
TCCCCAAAAGC -> CCCCAAAAGCG
CCCCAAAAGCG -> CCCAAAAGCGA
CCCAAAAGCGA -> CCAAAAGCGAT
CCAAAAGCGAT -> CAAAAGCGATG
CAAAAGCGATG -> AAAAGCGATGC
AAAAGCGATGC -> AAAGCGATGCT
AAAGCGATGCT -> AAGCGATGCTT
AAGCGATGCTT -> AGCGATGCTTT
AGCGATGCTTT -> GCGATGCTTTC
GCGATGCTTTC -> CGATGCTTTCG
CGATGCTTTCG -> GATGCTTTCGC
GATGCTTTCGC -> ATGCTTTCGCT
ATGCTTTCGCT -> TGCTTTCGCTG
TGCTTTCGCTG -> GCTTTCGCTGG
GCTTTCGCTGG -> CTTTCGCTGGT
CTTTCGCTGGT -> TTTCGCTGGTA
TTTCGCTGGTA -> TTCGCTGGTAT
TTCGCTGGTAT -> TCGCTGGTATG
TCGCTGGTATG -> CGCTGGTATGA
CGCTGGTATGA -> GCTGGTATGAG
GCTGGTATGAG -> CTGGTATGAGT
CTGGTATGAGT -> TGGTATGAGTA
TGGTATGAGTA -> GGTATGAGTAT
GGTATGAGTAT -> GTATGAGTATT
GTATGAGTATT -> TATGAGTATTT
TATGAGTATTT -> ATGAGTATTTG
ATGAGTATTTG -> TGAGTATTTGG
TGAGTATTTGG -> GAGTATTTGGC
GAGTATTTGGC -> AGTATTTGGCA
AGTATTTGGCA -> GTATTTGGCAA
GTATTTGGCAA -> TATTTGGCAAG
TATTTGGCAAG -> ATTTGGCAAGA
ATTTGGCAAGA -> TTTGGCAAGAA
TTTGGCAAGAA -> TTGGCAAGAAT
TTGGCAAGAAT -> TGGCAAGAATG
TGGCAAGAATG -> GGCAAGAATGC
GGCAAGAATGC -> GCAAGAATGCG
GCAAGAATGCG -> CAAGAATGCGT
CAAGAATGCGT -> AAGAATGCGTC
AAGAATGCGTC -> AGAATGCGTCA
AGAATGCGTCA -> GAATGCGTCAT
GAATGCGTCAT -> AATGCGTCATG
AATGCGTCATG -> ATGCGTCATGG
ATGCGTCATGG -> TGCGTCATGGC
TGCGTCATGGC -> GCGTCATGGCT
GCGTCATGGCT -> CGTCATGGCTG
CGTCATGGCTG -> GTCATGGCTGC
GTCATGGCTGC -> TCATGGCTGCG
TCATGGCTGCG -> CATGGCTGCGA
CATGGCTGCGA -> ATGGCTGCGAA
ATGGCTGCGAA -> TGGCTGCGAAG
TGGCTGCGAAG -> GGCTGCGAAGG
GGCTGCGAAGG -> GCTGCGAAGGA
GCTGCGAAGGA -> CTGCGAAGGAC
CTGCGAAGGAC -> TGCGAAGGACC
TGCGAAGGACC -> GCGAAGGACCT
GCGAAGGACCT -> CGAAGGACCTG
CGAAGGACCTG -> GAAGGACCTGC
GAAGGACCTGC -> AAGGACCTGCG
AAGGACCTGCG -> AGGACCTGCGA
AGGACCTGCGA -> GGACCTGCGAC
GGACCTGCGAC -> GACCTGCGACG
GACCTGCGACG -> ACCTGCGACGA
ACCTGCGACGA -> CCTGCGACGAA
CCTGCGACGAA -> CTGCGACGAAT
CTGCGACGAAT -> TGCGACGAATA
TGCGACGAATA -> GCGACGAATAG
GCGACGAATAG -> CGACGAATAGA
CGACGAATAGA -> GACGAATAGAC
GACGAATAGAC -> ACGAATAGACT
ACGAATAGACT -> CGAATAGACTC
CGAATAGACTC -> GAATAGACTCT
GAATAGACTCT -> AATAGACTCTT
AATAGACTCTT -> ATAGACTCTTA
ATAGACTCTTA -> TAGACTCTTAT
TAGACTCTTAT -> AGACTCTTATC
AGACTCTTATC -> GACTCTTATCC
GACTCTTATCC -> ACTCTTATCCG
ACTCTTATCCG -> CTCTTATCCGC
CTCTTATCCGC -> TCTTATCCGCT
TCTTATCCGCT -> CTTATCCGCTG
CTTATCCGCTG -> TTATCCGCTGC
TTATCCGCTGC -> TATCCGCTGCA
TATCCGCTGCA -> ATCCGCTGCAA
ATCCGCTGCAA -> TCCGCTGCAAC
TCCGCTGCAAC -> CCGCTGCAACG
CCGCTGCAACG -> CGCTGCAACGA
CGCTGCAACGA -> GCTGCAACGAT
GCTGCAACGAT -> CTGCAACGATT
CTGCAACGATT -> TGCAACGATTG
TGCAACGATTG -> GCAACGATTGT
GCAACGATTGT -> CAACGATTGTG
CAACGATTGTG -> AACGATTGTGT
AACGATTGTGT -> ACGATTGTGTG
ACGATTGTGTG -> CGATTGTGTGC
CGATTGTGTGC -> GATTGTGTGCA
GATTGTGTGCA -> ATTGTGTGCAG
ATTGTGTGCAG -> TTGTGTGCAGG
TTGTGTGCAGG -> TGTGTGCAGGC
TGTGTGCAGGC -> GTGTGCAGGCG
GTGTGCAGGCG -> TGTGCAGGCGG
TGTGCAGGCGG -> GTGCAGGCGGG
GTGCAGGCGGG -> TGCAGGCGGGT
TGCAGGCGGGT -> GCAGGCGGGTA
GCAGGCGGGTA -> CAGGCGGGTAT
CAGGCGGGTAT -> AGGCGGGTATC
AGGCGGGTATC -> GGCGGGTATCG
GGCGGGTATCG -> GCGGGTATCGT
GCGGGTATCGT -> CGGGTATCGTC
CGGGTATCGTC -> GGGTATCGTCT
GGGTATCGTCT -> GGTATCGTCTG
GGTATCGTCTG -> GTATCGTCTGA
GTATCGTCTGA -> TATCGTCTGAC
TATCGTCTGAC -> ATCGTCTGACG
ATCGTCTGACG -> TCGTCTGACGA
TCGTCTGACGA -> CGTCTGACGAG
CGTCTGACGAG -> GTCTGACGAGG
GTCTGACGAGG -> TCTGACGAGGG
TCTGACGAGGG -> CTGACGAGGGA
CTGACGAGGGA -> TGACGAGGGAT
TGACGAGGGAT -> GACGAGGGATC
GACGAGGGATC -> ACGAGGGATCG
ACGAGGGATCG -> CGAGGGATCGC
CGAGGGATCGC -> GAGGGATCGCC
GAGGGATCGCC -> AGGGATCGCCT
AGGGATCGCCT -> GGGATCGCCTT
GGGATCGCCTT -> GGATCGCCTTG
GGATCGCCTTG -> GATCGCCTTGG
GATCGCCTTGG -> ATCGCCTTGGA
ATCGCCTTGGA -> TCGCCTTGGAT
TCGCCTTGGAT -> CGCCTTGGATG
CGCCTTGGATG -> GCCTTGGATGC
GCCTTGGATGC -> CCTTGGATGCT
CCTTGGATGCT -> CTTGGATGCTC
CTTGGATGCTC -> TTGGATGCTCC
TTGGATGCTCC -> TGGATGCTCCA
TGGATGCTCCA -> GGATGCTCCAC
GGATGCTCCAC -> GATGCTCCACA
GATGCTCCACA -> ATGCTCCACAA
ATGCTCCACAA -> TGCTCCACAAT
TGCTCCACAAT -> GCTCCACAATA
GCTCCACAATA -> CTCCACAATAC
CTCCACAATAC -> TCCACAATACG
TCCACAATACG -> CCACAATACGC
CCACAATACGC -> CACAATACGCT
CACAATACGCT -> ACAATACGCTA
ACAATACGCTA -> CAATACGCTAC
CAATACGCTAC -> AATACGCTACA
AATACGCTACA -> ATACGCTACAA
ATACGCTACAA -> TACGCTACAAG
TACGCTACAAG -> ACGCTACAAGT
ACGCTACAAGT -> CGCTACAAGTC
CGCTACAAGTC -> GCTACAAGTCC
GCTACAAGTCC -> CTACAAGTCCT
CTACAAGTCCT -> TACAAGTCCTG
TACAAGTCCTG -> ACAAGTCCTGA
ACAAGTCCTGA -> CAAGTCCTGAG
CAAGTCCTGAG -> AAGTCCTGAGC
AAGTCCTGAGC -> AGTCCTGAGCC
AGTCCTGAGCC -> GTCCTGAGCCT
GTCCTGAGCCT -> TCCTGAGCCTC
TCCTGAGCCTC -> CCTGAGCCTCG
CCTGAGCCTCG -> CTGAGCCTCGA
CTGAGCCTCGA -> TGAGCCTCGAG
TGAGCCTCGAG -> GAGCCTCGAGC
GAGCCTCGAGC -> AGCCTCGAGCT
AGCCTCGAGCT -> GCCTCGAGCTG
GCCTCGAGCTG -> CCTCGAGCTGA
CCTCGAGCTGA -> CTCGAGCTGAT
CTCGAGCTGAT -> TCGAGCTGATC
TCGAGCTGATC -> CGAGCTGATCC
CGAGCTGATCC -> GAGCTGATCCC
GAGCTGATCCC -> AGCTGATCCCC
AGCTGATCCCC -> GCTGATCCCCG
GCTGATCCCCG -> CTGATCCCCGA
CTGATCCCCGA -> TGATCCCCGAT
TGATCCCCGAT -> GATCCCCGATA
GATCCCCGATA -> ATCCCCGATAA
ATCCCCGATAA -> TCCCCGATAAC
TCCCCGATAAC -> CCCCGATAACC
CCCCGATAACC -> CCCGATAACCG
CCCGATAACCG -> CCGATAACCGC
CCGATAACCGC -> CGATAACCGCT
CGATAACCGCT -> GATAACCGCTT
GATAACCGCTT -> ATAACCGCTTG
ATAACCGCTTG -> TAACCGCTTGC
TAACCGCTTGC -> AACCGCTTGCC
AACCGCTTGCC -> ACCGCTTGCCA
ACCGCTTGCCA -> CCGCTTGCCAG
CCGCTTGCCAG -> CGCTTGCCAGG
CGCTTGCCAGG -> GCTTGCCAGGG
GCTTGCCAGGG -> CTTGCCAGGGT
CTTGCCAGGGT -> TTGCCAGGGTA
TTGCCAGGGTA -> TGCCAGGGTAT
TGCCAGGGTAT -> GCCAGGGTATA
GCCAGGGTATA -> CCAGGGTATAA
CCAGGGTATAA -> CAGGGTATAAA
CAGGGTATAAA -> AGGGTATAAAC
AGGGTATAAAC -> GGGTATAAACA
GGGTATAAACA -> GGTATAAACAT
GGTATAAACAT -> GTATAAACATT
GTATAAACATT -> TATAAACATTA
TATAAACATTA -> ATAAACATTAT
ATAAACATTAT -> TAAACATTATT
TAAACATTATT -> AAACATTATTT
AAACATTATTT -> AACATTATTTA
AACATTATTTA -> ACATTATTTAA
ACATTATTTAA -> CATTATTTAAC
CATTATTTAAC -> ATTATTTAACA
ATTATTTAACA -> TTATTTAACAC
TTATTTAACAC -> TATTTAACACC
TATTTAACACC -> ATTTAACACCG
ATTTAACACCG -> TTTAACACCGT
TTTAACACCGT -> TTAACACCGTG
TTAACACCGTG -> TAACACCGTGG
TAACACCGTGG -> AACACCGTGGA
AACACCGTGGA -> ACACCGTGGAC
ACACCGTGGAC -> CACCGTGGACT
CACCGTGGACT -> ACCGTGGACTA
ACCGTGGACTA -> CCGTGGACTAT
CCGTGGACTAT -> CGTGGACTATC
CGTGGACTATC -> GTGGACTATCT
GTGGACTATCT -> TGGACTATCTA
TGGACTATCTA -> GGACTATCTAA
GGACTATCTAA -> GACTATCTAAA
GACTATCTAAA -> ACTATCTAAAA
ACTATCTAAAA -> CTATCTAAAAT
CTATCTAAAAT -> TATCTAAAATA
TATCTAAAATA -> ATCTAAAATAT
ATCTAAAATAT -> TCTAAAATATT
TCTAAAATATT -> CTAAAATATTG
CTAAAATATTG -> TAAAATATTGT
TAAAATATTGT -> AAAATATTGTG
AAAATATTGTG -> AAATATTGTGC
AAATATTGTGC -> AATATTGTGCT
AATATTGTGCT -> ATATTGTGCTA
ATATTGTGCTA -> TATTGTGCTAA
TATTGTGCTAA -> ATTGTGCTAAG
ATTGTGCTAAG -> TTGTGCTAAGA
TTGTGCTAAGA -> TGTGCTAAGAC
TGTGCTAAGAC -> GTGCTAAGACT
GTGCTAAGACT -> TGCTAAGACTC
TGCTAAGACTC -> GCTAAGACTCA
GCTAAGACTCA -> CTAAGACTCAC
CTAAGACTCAC -> TAAGACTCACC
TAAGACTCACC -> AAGACTCACCG
AAGACTCACCG -> AGACTCACCGC
AGACTCACCGC -> GACTCACCGCG
GACTCACCGCG -> ACTCACCGCGT
ACTCACCGCGT -> CTCACCGCGTA
CTCACCGCGTA -> TCACCGCGTAT
TCACCGCGTAT -> CACCGCGTATC
CACCGCGTATC -> ACCGCGTATCA
ACCGCGTATCA -> CCGCGTATCAG
CCGCGTATCAG -> CGCGTATCAGC
CGCGTATCAGC -> GCGTATCAGCG
GCGTATCAGCG -> CGTATCAGCGC
CGTATCAGCGC -> GTATCAGCGCT
GTATCAGCGCT -> TATCAGCGCTC
TATCAGCGCTC -> ATCAGCGCTCG
ATCAGCGCTCG -> TCAGCGCTCGC
TCAGCGCTCGC -> CAGCGCTCGCC
CAGCGCTCGCC -> AGCGCTCGCCA
AGCGCTCGCCA -> GCGCTCGCCAA
GCGCTCGCCAA -> CGCTCGCCAAT
CGCTCGCCAAT -> GCTCGCCAATA
GCTCGCCAATA -> CTCGCCAATAA
CTCGCCAATAA -> TCGCCAATAAC
TCGCCAATAAC -> CGCCAATAACA
CGCCAATAACA -> GCCAATAACAT
GCCAATAACAT -> CCAATAACATG
CCAATAACATG -> CAATAACATGA
CAATAACATGA -> AATAACATGAT
AATAACATGAT -> ATAACATGATC
ATAACATGATC -> TAACATGATCC
TAACATGATCC -> AACATGATCCG
AACATGATCCG -> ACATGATCCGT
ACATGATCCGT -> CATGATCCGTT
CATGATCCGTT -> ATGATCCGTTT
ATGATCCGTTT -> TGATCCGTTTG
TGATCCGTTTG -> GATCCGTTTGG
GATCCGTTTGG -> ATCCGTTTGGC
ATCCGTTTGGC -> TCCGTTTGGCG
TCCGTTTGGCG -> CCGTTTGGCGC
CCGTTTGGCGC -> CGTTTGGCGCG
CGTTTGGCGCG -> GTTTGGCGCGC
GTTTGGCGCGC -> TTTGGCGCGCG
TTTGGCGCGCG -> TTGGCGCGCGG
TTGGCGCGCGG -> TGGCGCGCGGC
TGGCGCGCGGC -> GGCGCGCGGCC
GGCGCGCGGCC -> GCGCGCGGCCA
GCGCGCGGCCA -> CGCGCGGCCAA
CGCGCGGCCAA -> GCGCGGCCAAG
GCGCGGCCAAG -> CGCGGCCAAGG
CGCGGCCAAGG -> GCGGCCAAGGT
GCGGCCAAGGT -> CGGCCAAGGTA
CGGCCAAGGTA -> GGCCAAGGTAT
GGCCAAGGTAT -> GCCAAGGTATT
GCCAAGGTATT -> CCAAGGTATTG
CCAAGGTATTG -> CAAGGTATTGC
CAAGGTATTGC -> AAGGTATTGCG
AAGGTATTGCG -> AGGTATTGCGT
AGGTATTGCGT -> GGTATTGCGTT
GGTATTGCGTT -> GTATTGCGTTA
GTATTGCGTTA -> TATTGCGTTAT
TATTGCGTTAT -> ATTGCGTTATG
ATTGCGTTATG -> TTGCGTTATGC
TTGCGTTATGC -> TGCGTTATGCC
TGCGTTATGCC -> GCGTTATGCCT
GCGTTATGCCT -> CGTTATGCCTG
CGTTATGCCTG -> GTTATGCCTGG
GTTATGCCTGG -> TTATGCCTGGT
TTATGCCTGGT -> TATGCCTGGTG
TATGCCTGGTG -> ATGCCTGGTGG
ATGCCTGGTGG -> TGCCTGGTGGA
TGCCTGGTGGA -> GCCTGGTGGAT
GCCTGGTGGAT -> CCTGGTGGATA
CCTGGTGGATA -> CTGGTGGATAC
CTGGTGGATAC -> TGGTGGATACT
TGGTGGATACT -> GGTGGATACTG
GGTGGATACTG -> GTGGATACTGA
GTGGATACTGA -> TGGATACTGAC
TGGATACTGAC -> GGATACTGACG
GGATACTGACG -> GATACTGACGC
GATACTGACGC -> ATACTGACGCC
ATACTGACGCC -> TACTGACGCCA
TACTGACGCCA -> ACTGACGCCAG
ACTGACGCCAG -> CTGACGCCAGC
CTGACGCCAGC -> TGACGCCAGCG
TGACGCCAGCG -> GACGCCAGCGA, GACGCCAGCGT
GACGCCAGCGA -> ACGCCAGCGAC
ACGCCAGCGAC -> CGCCAGCGACG
CGCCAGCGACG -> GCCAGCGACGC
GCCAGCGACGC -> CCAGCGACGCG
CCAGCGACGCG -> CAGCGACGCGG
CAGCGACGCGG -> AGCGACGCGGT
AGCGACGCGGT -> GCGACGCGGTT
GCGACGCGGTT -> CGACGCGGTTG
CGACGCGGTTG -> GACGCGGTTGC
GACGCGGTTGC -> ACGCGGTTGCG
ACGCGGTTGCG -> CGCGGTTGCGG
CGCGGTTGCGG -> GCGGTTGCGGA
GCGGTTGCGGA -> CGGTTGCGGAG
CGGTTGCGGAG -> GGTTGCGGAGA
GGTTGCGGAGA -> GTTGCGGAGAC
GTTGCGGAGAC -> TTGCGGAGACG
TTGCGGAGACG -> TGCGGAGACGG
TGCGGAGACGG -> GCGGAGACGGA
GCGGAGACGGA -> CGGAGACGGAA
CGGAGACGGAA -> GGAGACGGAAA
GGAGACGGAAA -> GAGACGGAAAA
GAGACGGAAAA -> AGACGGAAAAT
AGACGGAAAAT -> GACGGAAAATG
GACGGAAAATG -> ACGGAAAATGG
ACGGAAAATGG -> CGGAAAATGGC
CGGAAAATGGC -> GGAAAATGGCT
GGAAAATGGCT -> GAAAATGGCTT
GAAAATGGCTT -> AAAATGGCTTG
AAAATGGCTTG -> AAATGGCTTGC
AAATGGCTTGC -> AATGGCTTGCG
AATGGCTTGCG -> ATGGCTTGCGA
ATGGCTTGCGA -> TGGCTTGCGAG
TGGCTTGCGAG -> GGCTTGCGAGT
GGCTTGCGAGT -> GCTTGCGAGTA
GCTTGCGAGTA -> CTTGCGAGTAC
CTTGCGAGTAC -> TTGCGAGTACC
TTGCGAGTACC -> TGCGAGTACCC
TGCGAGTACCC -> GCGAGTACCCA
GCGAGTACCCA -> CGAGTACCCAT
CGAGTACCCAT -> GAGTACCCATC
GAGTACCCATC -> AGTACCCATCA
AGTACCCATCA -> GTACCCATCAA
GTACCCATCAA -> TACCCATCAAG
TACCCATCAAG -> ACCCATCAAGG
ACCCATCAAGG -> CCCATCAAGGT
CCCATCAAGGT -> CCATCAAGGTT
CCATCAAGGTT -> CATCAAGGTTT
CATCAAGGTTT -> ATCAAGGTTTT
ATCAAGGTTTT -> TCAAGGTTTTA
TCAAGGTTTTA -> CAAGGTTTTAA
CAAGGTTTTAA -> AAGGTTTTAAT
AAGGTTTTAAT -> AGGTTTTAATC
AGGTTTTAATC -> GGTTTTAATCC
GGTTTTAATCC -> GTTTTAATCCT
GTTTTAATCCT -> TTTTAATCCTG
TTTTAATCCTG -> TTTAATCCTGT
TTTAATCCTGT -> TTAATCCTGTG
TTAATCCTGTG -> TAATCCTGTGG
TAATCCTGTGG -> AATCCTGTGGA
AATCCTGTGGA -> ATCCTGTGGAG
ATCCTGTGGAG -> TCCTGTGGAGC
TCCTGTGGAGC -> CCTGTGGAGCA
CCTGTGGAGCA -> CTGTGGAGCAC
CTGTGGAGCAC -> TGTGGAGCACG
TGTGGAGCACG -> GTGGAGCACGC
GTGGAGCACGC -> TGGAGCACGCA
TGGAGCACGCA -> GGAGCACGCAT
GGAGCACGCAT -> GAGCACGCATA
GAGCACGCATA -> AGCACGCATAT
AGCACGCATAT -> GCACGCATATT
GCACGCATATT -> CACGCATATTG
CACGCATATTG -> ACGCATATTGG
ACGCATATTGG -> CGCATATTGGT
CGCATATTGGT -> GCATATTGGTA
GCATATTGGTA -> CATATTGGTAC
CATATTGGTAC -> ATATTGGTACT
ATATTGGTACT -> TATTGGTACTC
TATTGGTACTC -> ATTGGTACTCT
ATTGGTACTCT -> TTGGTACTCTA
TTGGTACTCTA -> TGGTACTCTAT
TGGTACTCTAT -> GGTACTCTATT
GGTACTCTATT -> GTACTCTATTT
GTACTCTATTT -> TACTCTATTTA
TACTCTATTTA -> ACTCTATTTAC
ACTCTATTTAC -> CTCTATTTACA
CTCTATTTACA -> TCTATTTACAA
TCTATTTACAA -> CTATTTACAAT
CTATTTACAAT -> TATTTACAATA
TATTTACAATA -> ATTTACAATAC
ATTTACAATAC -> TTTACAATACC
TTTACAATACC -> TTACAATACCC
TTACAATACCC -> TACAATACCCG
TACAATACCCG -> ACAATACCCGT
ACAATACCCGT -> CAATACCCGTG
CAATACCCGTG -> AATACCCGTGG
AATACCCGTGG -> ATACCCGTGGG
ATACCCGTGGG -> TACCCGTGGGA
TACCCGTGGGA -> ACCCGTGGGAG
ACCCGTGGGAG -> CCCGTGGGAGC
CCCGTGGGAGC -> CCGTGGGAGCG
CCGTGGGAGCG -> CGTGGGAGCGG
CGTGGGAGCGG -> GTGGGAGCGGA
GTGGGAGCGGA -> TGGGAGCGGAT
TGGGAGCGGAT -> GGGAGCGGATT
GGGAGCGGATT -> GGAGCGGATTG
GGAGCGGATTG -> GAGCGGATTGA
GAGCGGATTGA -> AGCGGATTGAT
AGCGGATTGAT -> GCGGATTGATA
GCGGATTGATA -> CGGATTGATAC
CGGATTGATAC -> GGATTGATACT
GGATTGATACT -> GATTGATACTC
GATTGATACTC -> ATTGATACTCT
ATTGATACTCT -> TTGATACTCTT
TTGATACTCTT -> TGATACTCTTC
TGATACTCTTC -> GATACTCTTCA
GATACTCTTCA -> ATACTCTTCAG
ATACTCTTCAG -> TACTCTTCAGG
TACTCTTCAGG -> ACTCTTCAGGC
ACTCTTCAGGC -> CTCTTCAGGCT
CTCTTCAGGCT -> TCTTCAGGCTA
TCTTCAGGCTA -> CTTCAGGCTAC
CTTCAGGCTAC -> TTCAGGCTACG
TTCAGGCTACG -> TCAGGCTACGT
TCAGGCTACGT -> CAGGCTACGTT
CAGGCTACGTT -> AGGCTACGTTG
AGGCTACGTTG -> GGCTACGTTGA
GGCTACGTTGA -> GCTACGTTGAC
GCTACGTTGAC -> CTACGTTGACG
CTACGTTGACG -> TACGTTGACGA
TACGTTGACGA -> ACGTTGACGAT
ACGTTGACGAT -> CGTTGACGATG
CGTTGACGATG -> GTTGACGATGA
GTTGACGATGA -> TTGACGATGAG
TTGACGATGAG -> TGACGATGAGT
TGACGATGAGT -> GACGATGAGTA
GACGATGAGTA -> ACGATGAGTAG
ACGATGAGTAG -> CGATGAGTAGC
CGATGAGTAGC -> GATGAGTAGCT
GATGAGTAGCT -> ATGAGTAGCTG
ATGAGTAGCTG -> TGAGTAGCTGT
TGAGTAGCTGT -> GAGTAGCTGTC
GAGTAGCTGTC -> AGTAGCTGTCT
AGTAGCTGTCT -> GTAGCTGTCTT
GTAGCTGTCTT -> TAGCTGTCTTA
TAGCTGTCTTA -> AGCTGTCTTAG
AGCTGTCTTAG -> GCTGTCTTAGT
GCTGTCTTAGT -> CTGTCTTAGTA
CTGTCTTAGTA -> TGTCTTAGTAT
TGTCTTAGTAT -> GTCTTAGTATG
GTCTTAGTATG -> TCTTAGTATGC
TCTTAGTATGC -> CTTAGTATGCT
CTTAGTATGCT -> TTAGTATGCTC
TTAGTATGCTC -> TAGTATGCTCA
TAGTATGCTCA -> AGTATGCTCAT
AGTATGCTCAT -> GTATGCTCATG
GTATGCTCATG -> TATGCTCATGC
TATGCTCATGC -> ATGCTCATGCG
ATGCTCATGCG -> TGCTCATGCGA
TGCTCATGCGA -> GCTCATGCGAC
GCTCATGCGAC -> CTCATGCGACA
CTCATGCGACA -> TCATGCGACAA
TCATGCGACAA -> CATGCGACAAG
CATGCGACAAG -> ATGCGACAAGG
ATGCGACAAGG -> TGCGACAAGGA
TGCGACAAGGA -> GCGACAAGGAT
GCGACAAGGAT -> CGACAAGGATT
CGACAAGGATT -> GACAAGGATTG
GACAAGGATTG -> ACAAGGATTGC
ACAAGGATTGC -> CAAGGATTGCT
CAAGGATTGCT -> AAGGATTGCTT
AAGGATTGCTT -> AGGATTGCTTC
AGGATTGCTTC -> GGATTGCTTCC
GGATTGCTTCC -> GATTGCTTCCG
GATTGCTTCCG -> ATTGCTTCCGC
ATTGCTTCCGC -> TTGCTTCCGCG
TTGCTTCCGCG -> TGCTTCCGCGA
TGCTTCCGCGA -> GCTTCCGCGAA
GCTTCCGCGAA -> CTTCCGCGAAA
CTTCCGCGAAA -> TTCCGCGAAAT
TTCCGCGAAAT -> TCCGCGAAATA
TCCGCGAAATA -> CCGCGAAATAA
CCGCGAAATAA -> CGCGAAATAAT
CGCGAAATAAT -> GCGAAATAATC
GCGAAATAATC -> CGAAATAATCG
CGAAATAATCG -> GAAATAATCGG
GAAATAATCGG -> AAATAATCGGG
AAATAATCGGG -> AATAATCGGGT
AATAATCGGGT -> ATAATCGGGTC
ATAATCGGGTC -> TAATCGGGTCG
TAATCGGGTCG -> AATCGGGTCGA
AATCGGGTCGA -> ATCGGGTCGAG
ATCGGGTCGAG -> TCGGGTCGAGC
TCGGGTCGAGC -> CGGGTCGAGCG
CGGGTCGAGCG -> GGGTCGAGCGA
GGGTCGAGCGA -> GGTCGAGCGAG
GGTCGAGCGAG -> GTCGAGCGAGA
GTCGAGCGAGA -> TCGAGCGAGAC
TCGAGCGAGAC -> CGAGCGAGACA
CGAGCGAGACA -> GAGCGAGACAA
GAGCGAGACAA -> AGCGAGACAAA
AGCGAGACAAA -> GCGAGACAAAT
GCGAGACAAAT -> CGAGACAAATA
CGAGACAAATA -> GAGACAAATAA
GAGACAAATAA -> AGACAAATAAC
AGACAAATAAC -> GACAAATAACC
GACAAATAACC -> ACAAATAACCA
ACAAATAACCA -> CAAATAACCAA
CAAATAACCAA -> AAATAACCAAA
AAATAACCAAA -> AATAACCAAAG
AATAACCAAAG -> ATAACCAAAGA
ATAACCAAAGA -> TAACCAAAGAT
TAACCAAAGAT -> AACCAAAGATC
AACCAAAGATC -> ACCAAAGATCA
ACCAAAGATCA -> CCAAAGATCAG
CCAAAGATCAG -> CAAAGATCAGG
CAAAGATCAGG -> AAAGATCAGGT
AAAGATCAGGT -> AAGATCAGGTC
AAGATCAGGTC -> AGATCAGGTCA
AGATCAGGTCA -> GATCAGGTCAT
GATCAGGTCAT -> ATCAGGTCATC
ATCAGGTCATC -> TCAGGTCATCT
TCAGGTCATCT -> CAGGTCATCTG
CAGGTCATCTG -> AGGTCATCTGT
AGGTCATCTGT -> GGTCATCTGTA
GGTCATCTGTA -> GTCATCTGTAT
GTCATCTGTAT -> TCATCTGTATG
TCATCTGTATG -> CATCTGTATGT
CATCTGTATGT -> ATCTGTATGTA
ATCTGTATGTA -> TCTGTATGTAG
TCTGTATGTAG -> CTGTATGTAGT
CTGTATGTAGT -> TGTATGTAGTT
TGTATGTAGTT -> GTATGTAGTTA
GTATGTAGTTA -> TATGTAGTTAA
TATGTAGTTAA -> ATGTAGTTAAC
ATGTAGTTAAC -> TGTAGTTAACC
TGTAGTTAACC -> GTAGTTAACCG
GTAGTTAACCG -> TAGTTAACCGA
TAGTTAACCGA -> AGTTAACCGAA
AGTTAACCGAA -> GTTAACCGAAC
GTTAACCGAAC -> TTAACCGAACA
TTAACCGAACA -> TAACCGAACAG
TAACCGAACAG -> AACCGAACAGA
AACCGAACAGA -> ACCGAACAGAC
ACCGAACAGAC -> CCGAACAGACA
CCGAACAGACA -> CGAACAGACAG
CGAACAGACAG -> GAACAGACAGG
GAACAGACAGG -> AACAGACAGGT
AACAGACAGGT -> ACAGACAGGTT
ACAGACAGGTT -> CAGACAGGTTC
CAGACAGGTTC -> AGACAGGTTCA
AGACAGGTTCA -> GACAGGTTCAG
GACAGGTTCAG -> ACAGGTTCAGT
ACAGGTTCAGT -> CAGGTTCAGTA
CAGGTTCAGTA -> AGGTTCAGTAA
AGGTTCAGTAA -> GGTTCAGTAAA
GGTTCAGTAAA -> GTTCAGTAAAC
GTTCAGTAAAC -> TTCAGTAAACG
TTCAGTAAACG -> TCAGTAAACGT
TCAGTAAACGT -> CAGTAAACGTA
CAGTAAACGTA -> AGTAAACGTAG
AGTAAACGTAG -> GTAAACGTAGT
GTAAACGTAGT -> TAAACGTAGTA
TAAACGTAGTA -> AAACGTAGTAT
AAACGTAGTAT -> AACGTAGTATT
AACGTAGTATT -> ACGTAGTATTT
ACGTAGTATTT -> CGTAGTATTTG
CGTAGTATTTG -> GTAGTATTTGA
GTAGTATTTGA -> TAGTATTTGAG
TAGTATTTGAG -> AGTATTTGAGG
AGTATTTGAGG -> GTATTTGAGGA
GTATTTGAGGA -> TATTTGAGGAC
TATTTGAGGAC -> ATTTGAGGACT
ATTTGAGGACT -> TTTGAGGACTC
TTTGAGGACTC -> TTGAGGACTCT
TTGAGGACTCT -> TGAGGACTCTA
TGAGGACTCTA -> GAGGACTCTAG
GAGGACTCTAG -> AGGACTCTAGC
AGGACTCTAGC -> GGACTCTAGCT
GGACTCTAGCT -> GACTCTAGCTG
GACTCTAGCTG -> ACTCTAGCTGC
ACTCTAGCTGC -> CTCTAGCTGCA
CTCTAGCTGCA -> TCTAGCTGCAG
TCTAGCTGCAG -> CTAGCTGCAGC
CTAGCTGCAGC -> TAGCTGCAGCG
TAGCTGCAGCG -> AGCTGCAGCGG
AGCTGCAGCGG -> GCTGCAGCGGT
GCTGCAGCGGT -> CTGCAGCGGTA
CTGCAGCGGTA -> TGCAGCGGTAA
TGCAGCGGTAA -> GCAGCGGTAAG
GCAGCGGTAAG -> CAGCGGTAAGT
CAGCGGTAAGT -> AGCGGTAAGTG
AGCGGTAAGTG -> GCGGTAAGTGC
GCGGTAAGTGC -> CGGTAAGTGCT
CGGTAAGTGCT -> GGTAAGTGCTG
GGTAAGTGCTG -> GTAAGTGCTGG
GTAAGTGCTGG -> TAAGTGCTGGC
TAAGTGCTGGC -> AAGTGCTGGCA
AAGTGCTGGCA -> AGTGCTGGCAG
AGTGCTGGCAG -> GTGCTGGCAGG
GTGCTGGCAGG -> TGCTGGCAGGT
TGCTGGCAGGT -> GCTGGCAGGTC
GCTGGCAGGTC -> CTGGCAGGTCT
CTGGCAGGTCT -> TGGCAGGTCTC
TGGCAGGTCTC -> GGCAGGTCTCG
GGCAGGTCTCG -> GCAGGTCTCGT
GCAGGTCTCGT -> CAGGTCTCGTC
CAGGTCTCGTC -> AGGTCTCGTCC
AGGTCTCGTCC -> GGTCTCGTCCC
GGTCTCGTCCC -> GTCTCGTCCCT
GTCTCGTCCCT -> TCTCGTCCCTA
TCTCGTCCCTA -> CTCGTCCCTAC
CTCGTCCCTAC -> TCGTCCCTACA
TCGTCCCTACA -> CGTCCCTACAC
CGTCCCTACAC -> GTCCCTACACG
GTCCCTACACG -> TCCCTACACGT
TCCCTACACGT -> CCCTACACGTT
CCCTACACGTT -> CCTACACGTTT
CCTACACGTTT -> CTACACGTTTC
CTACACGTTTC -> TACACGTTTCG
TACACGTTTCG -> ACACGTTTCGC
ACACGTTTCGC -> CACGTTTCGCC
CACGTTTCGCC -> ACGTTTCGCCC
ACGTTTCGCCC -> CGTTTCGCCCT
CGTTTCGCCCT -> GTTTCGCCCTA
GTTTCGCCCTA -> TTTCGCCCTAC
TTTCGCCCTAC -> TTCGCCCTACT
TTCGCCCTACT -> TCGCCCTACTA
TCGCCCTACTA -> CGCCCTACTAG
CGCCCTACTAG -> GCCCTACTAGT
GCCCTACTAGT -> CCCTACTAGTT
CCCTACTAGTT -> CCTACTAGTTG
CCTACTAGTTG -> CTACTAGTTGT
CTACTAGTTGT -> TACTAGTTGTT
TACTAGTTGTT -> ACTAGTTGTTT
ACTAGTTGTTT -> CTAGTTGTTTC
CTAGTTGTTTC -> TAGTTGTTTCT
TAGTTGTTTCT -> AGTTGTTTCTG
AGTTGTTTCTG -> GTTGTTTCTGA
GTTGTTTCTGA -> TTGTTTCTGAA
TTGTTTCTGAA -> TGTTTCTGAAC
TGTTTCTGAAC -> GTTTCTGAACT
GTTTCTGAACT -> TTTCTGAACTA
TTTCTGAACTA -> TTCTGAACTAT
TTCTGAACTAT -> TCTGAACTATC
TCTGAACTATC -> CTGAACTATCA
CTGAACTATCA -> TGAACTATCAA
TGAACTATCAA -> GAACTATCAAG
GAACTATCAAG -> AACTATCAAGC
AACTATCAAGC -> ACTATCAAGCG
ACTATCAAGCG -> CTATCAAGCGG
CTATCAAGCGG -> TATCAAGCGGC
TATCAAGCGGC -> ATCAAGCGGCC
ATCAAGCGGCC -> TCAAGCGGCCC
TCAAGCGGCCC -> CAAGCGGCCCC
CAAGCGGCCCC -> AAGCGGCCCCC
AAGCGGCCCCC -> AGCGGCCCCCC
AGCGGCCCCCC -> GCGGCCCCCCA
GCGGCCCCCCA -> CGGCCCCCCAT
CGGCCCCCCAT -> GGCCCCCCATC
GGCCCCCCATC -> GCCCCCCATCA
GCCCCCCATCA -> CCCCCCATCAT
CCCCCCATCAT -> CCCCCATCATG
CCCCCATCATG -> CCCCATCATGC
CCCCATCATGC -> CCCATCATGCA
CCCATCATGCA -> CCATCATGCAC
CCATCATGCAC -> CATCATGCACT
CATCATGCACT -> ATCATGCACTG
ATCATGCACTG -> TCATGCACTGT
TCATGCACTGT -> CATGCACTGTT
CATGCACTGTT -> ATGCACTGTTG
ATGCACTGTTG -> TGCACTGTTGC
TGCACTGTTGC -> GCACTGTTGCT
GCACTGTTGCT -> CACTGTTGCTT
CACTGTTGCTT -> ACTGTTGCTTT
ACTGTTGCTTT -> CTGTTGCTTTT
CTGTTGCTTTT -> TGTTGCTTTTC
TGTTGCTTTTC -> GTTGCTTTTCT
GTTGCTTTTCT -> TTGCTTTTCTG
TTGCTTTTCTG -> TGCTTTTCTGA
TGCTTTTCTGA -> GCTTTTCTGAG
GCTTTTCTGAG -> CTTTTCTGAGA
CTTTTCTGAGA -> TTTTCTGAGAG
TTTTCTGAGAG -> TTTCTGAGAGT
TTTCTGAGAGT -> TTCTGAGAGTA
TTCTGAGAGTA -> TCTGAGAGTAT
TCTGAGAGTAT -> CTGAGAGTATT
CTGAGAGTATT -> TGAGAGTATTG
TGAGAGTATTG -> GAGAGTATTGT
GAGAGTATTGT -> AGAGTATTGTT
AGAGTATTGTT -> GAGTATTGTTC
GAGTATTGTTC -> AGTATTGTTCA
AGTATTGTTCA -> GTATTGTTCAC
GTATTGTTCAC -> TATTGTTCACG
TATTGTTCACG -> ATTGTTCACGG
ATTGTTCACGG -> TTGTTCACGGC
TTGTTCACGGC -> TGTTCACGGCG
TGTTCACGGCG -> GTTCACGGCGT
GTTCACGGCGT -> TTCACGGCGTG
TTCACGGCGTG -> TCACGGCGTGG
TCACGGCGTGG -> CACGGCGTGGG
CACGGCGTGGG -> ACGGCGTGGGA
ACGGCGTGGGA -> CGGCGTGGGAT
CGGCGTGGGAT -> GGCGTGGGATA
GGCGTGGGATA -> GCGTGGGATAG
GCGTGGGATAG -> CGTGGGATAGG
CGTGGGATAGG -> GTGGGATAGGG
GTGGGATAGGG -> TGGGATAGGGT
TGGGATAGGGT -> GGGATAGGGTC
GGGATAGGGTC -> GGATAGGGTCC
GGATAGGGTCC -> GATAGGGTCCT
GATAGGGTCCT -> ATAGGGTCCTA
ATAGGGTCCTA -> TAGGGTCCTAA
TAGGGTCCTAA -> AGGGTCCTAAT
AGGGTCCTAAT -> GGGTCCTAATC
GGGTCCTAATC -> GGTCCTAATCT
GGTCCTAATCT -> GTCCTAATCTA
GTCCTAATCTA -> TCCTAATCTAG
TCCTAATCTAG -> CCTAATCTAGA
CCTAATCTAGA -> CTAATCTAGAC
CTAATCTAGAC -> TAATCTAGACG
TAATCTAGACG -> AATCTAGACGC
AATCTAGACGC -> ATCTAGACGCG
ATCTAGACGCG -> TCTAGACGCGC
TCTAGACGCGC -> CTAGACGCGCT
CTAGACGCGCT -> TAGACGCGCTC
TAGACGCGCTC -> AGACGCGCTCT
AGACGCGCTCT -> GACGCGCTCTT
GACGCGCTCTT -> ACGCGCTCTTA
ACGCGCTCTTA -> CGCGCTCTTAA
CGCGCTCTTAA -> GCGCTCTTAAG
GCGCTCTTAAG -> CGCTCTTAAGA
CGCTCTTAAGA -> GCTCTTAAGAG
GCTCTTAAGAG -> CTCTTAAGAGG
CTCTTAAGAGG -> TCTTAAGAGGG
TCTTAAGAGGG -> CTTAAGAGGGT
CTTAAGAGGGT -> TTAAGAGGGTC
TTAAGAGGGTC -> TAAGAGGGTCA
TAAGAGGGTCA -> AAGAGGGTCAG
AAGAGGGTCAG -> AGAGGGTCAGG
AGAGGGTCAGG -> GAGGGTCAGGT
GAGGGTCAGGT -> AGGGTCAGGTG
AGGGTCAGGTG -> GGGTCAGGTGT
GGGTCAGGTGT -> GGTCAGGTGTT
GGTCAGGTGTT -> GTCAGGTGTTA
GTCAGGTGTTA -> TCAGGTGTTAC
TCAGGTGTTAC -> CAGGTGTTACT
CAGGTGTTACT -> AGGTGTTACTC
AGGTGTTACTC -> GGTGTTACTCA
GGTGTTACTCA -> GTGTTACTCAA
GTGTTACTCAA -> TGTTACTCAAT
TGTTACTCAAT -> GTTACTCAATG
GTTACTCAATG -> TTACTCAATGT
TTACTCAATGT -> TACTCAATGTG
TACTCAATGTG -> ACTCAATGTGC
ACTCAATGTGC -> CTCAATGTGCT
CTCAATGTGCT -> TCAATGTGCTA
TCAATGTGCTA -> CAATGTGCTAG
CAATGTGCTAG -> AATGTGCTAGG
AATGTGCTAGG -> ATGTGCTAGGT
ATGTGCTAGGT -> TGTGCTAGGTT
TGTGCTAGGTT -> GTGCTAGGTTC
GTGCTAGGTTC -> TGCTAGGTTCA
TGCTAGGTTCA -> GCTAGGTTCAC
GCTAGGTTCAC -> CTAGGTTCACC
CTAGGTTCACC -> TAGGTTCACCA
TAGGTTCACCA -> AGGTTCACCAC
AGGTTCACCAC -> GGTTCACCACG
GGTTCACCACG -> GTTCACCACGC
GTTCACCACGC -> TTCACCACGCC
TTCACCACGCC -> TCACCACGCCA
TCACCACGCCA -> CACCACGCCAA
CACCACGCCAA -> ACCACGCCAAC
ACCACGCCAAC -> CCACGCCAACT
CCACGCCAACT -> CACGCCAACTA
CACGCCAACTA -> ACGCCAACTAA
ACGCCAACTAA -> CGCCAACTAAC
CGCCAACTAAC -> GCCAACTAACT
GCCAACTAACT -> CCAACTAACTA
CCAACTAACTA -> CAACTAACTAG
CAACTAACTAG -> AACTAACTAGA
AACTAACTAGA -> ACTAACTAGAG
ACTAACTAGAG -> CTAACTAGAGT
CTAACTAGAGT -> TAACTAGAGTA
TAACTAGAGTA -> AACTAGAGTAA
AACTAGAGTAA -> ACTAGAGTAAC
ACTAGAGTAAC -> CTAGAGTAACG
CTAGAGTAACG -> TAGAGTAACGA
TAGAGTAACGA -> AGAGTAACGAG
AGAGTAACGAG -> GAGTAACGAGG
GAGTAACGAGG -> AGTAACGAGGG
AGTAACGAGGG -> GTAACGAGGGG
GTAACGAGGGG -> TAACGAGGGGA
TAACGAGGGGA -> AACGAGGGGAA
AACGAGGGGAA -> ACGAGGGGAAT
ACGAGGGGAAT -> CGAGGGGAATT
CGAGGGGAATT -> GAGGGGAATTC
GAGGGGAATTC -> AGGGGAATTCT
AGGGGAATTCT -> GGGGAATTCTG
GGGGAATTCTG -> GGGAATTCTGG
GGGAATTCTGG -> GGAATTCTGGG
GGAATTCTGGG -> GAATTCTGGGA
GAATTCTGGGA -> AATTCTGGGAC
AATTCTGGGAC -> ATTCTGGGACT
ATTCTGGGACT -> TTCTGGGACTG
TTCTGGGACTG -> TCTGGGACTGA
TCTGGGACTGA -> CTGGGACTGAT
CTGGGACTGAT -> TGGGACTGATG
TGGGACTGATG -> GGGACTGATGA
GGGACTGATGA -> GGACTGATGAA
GGACTGATGAA -> GACTGATGAAG
GACTGATGAAG -> ACTGATGAAGT
ACTGATGAAGT -> CTGATGAAGTG
CTGATGAAGTG -> TGATGAAGTGG
TGATGAAGTGG -> GATGAAGTGGA
GATGAAGTGGA -> ATGAAGTGGAC
ATGAAGTGGAC -> TGAAGTGGACT
TGAAGTGGACT -> GAAGTGGACTA
GAAGTGGACTA -> AAGTGGACTAG
AAGTGGACTAG -> AGTGGACTAGA
AGTGGACTAGA -> GTGGACTAGAC
GTGGACTAGAC -> TGGACTAGACT
TGGACTAGACT -> GGACTAGACTC
GGACTAGACTC -> GACTAGACTCC
GACTAGACTCC -> ACTAGACTCCA
ACTAGACTCCA -> CTAGACTCCAG
CTAGACTCCAG -> TAGACTCCAGA
TAGACTCCAGA -> AGACTCCAGAG
AGACTCCAGAG -> GACTCCAGAGG
GACTCCAGAGG -> ACTCCAGAGGA
ACTCCAGAGGA -> CTCCAGAGGAC
CTCCAGAGGAC -> TCCAGAGGACA
TCCAGAGGACA -> CCAGAGGACAC
CCAGAGGACAC -> CAGAGGACACA
CAGAGGACACA -> AGAGGACACAT
AGAGGACACAT -> GAGGACACATC
GAGGACACATC -> AGGACACATCC
AGGACACATCC -> GGACACATCCG
GGACACATCCG -> GACACATCCGC
GACACATCCGC -> ACACATCCGCC
ACACATCCGCC -> CACATCCGCCG
CACATCCGCCG -> ACATCCGCCGA
ACATCCGCCGA -> CATCCGCCGAG
CATCCGCCGAG -> ATCCGCCGAGC
ATCCGCCGAGC -> TCCGCCGAGCG
TCCGCCGAGCG -> CCGCCGAGCGG
CCGCCGAGCGG -> CGCCGAGCGGC
CGCCGAGCGGC -> GCCGAGCGGCT
GCCGAGCGGCT -> CCGAGCGGCTA
CCGAGCGGCTA -> CGAGCGGCTAT
CGAGCGGCTAT -> GAGCGGCTATC
GAGCGGCTATC -> AGCGGCTATCA
AGCGGCTATCA -> GCGGCTATCAA
GCGGCTATCAA -> CGGCTATCAAT
CGGCTATCAAT -> GGCTATCAATT
GGCTATCAATT -> GCTATCAATTT
GCTATCAATTT -> CTATCAATTTG
CTATCAATTTG -> TATCAATTTGG
TATCAATTTGG -> ATCAATTTGGG
ATCAATTTGGG -> TCAATTTGGGG
TCAATTTGGGG -> CAATTTGGGGA
CAATTTGGGGA -> AATTTGGGGAA
AATTTGGGGAA -> ATTTGGGGAAT
ATTTGGGGAAT -> TTTGGGGAATC
TTTGGGGAATC -> TTGGGGAATCA
TTGGGGAATCA -> TGGGGAATCAT
TGGGGAATCAT -> GGGGAATCATC
GGGGAATCATC -> GGGAATCATCG
GGGAATCATCG -> GGAATCATCGA
GGAATCATCGA -> GAATCATCGAC
GAATCATCGAC -> AATCATCGACA
AATCATCGACA -> ATCATCGACAA
ATCATCGACAA -> TCATCGACAAA
TCATCGACAAA -> CATCGACAAAA
CATCGACAAAA -> ATCGACAAAAA
ATCGACAAAAA -> TCGACAAAAAG
TCGACAAAAAG -> CGACAAAAAGC
CGACAAAAAGC -> GACAAAAAGCC
GACAAAAAGCC -> ACAAAAAGCCT
ACAAAAAGCCT -> CAAAAAGCCTA
CAAAAAGCCTA -> AAAAAGCCTAA
AAAAAGCCTAA -> AAAAGCCTAAT
AAAAGCCTAAT -> AAAGCCTAATG
AAAGCCTAATG -> AAGCCTAATGG
AAGCCTAATGG -> AGCCTAATGGA
AGCCTAATGGA -> GCCTAATGGAA
GCCTAATGGAA -> CCTAATGGAAA
CCTAATGGAAA -> CTAATGGAAAT
CTAATGGAAAT -> TAATGGAAATA
TAATGGAAATA -> AATGGAAATAA
AATGGAAATAA -> ATGGAAATAAC
ATGGAAATAAC -> TGGAAATAACG
TGGAAATAACG -> GGAAATAACGG
GGAAATAACGG -> GAAATAACGGG
GAAATAACGGG -> AAATAACGGGA
AAATAACGGGA -> AATAACGGGAT
AATAACGGGAT -> ATAACGGGATG
ATAACGGGATG -> TAACGGGATGC
TAACGGGATGC -> AACGGGATGCA
AACGGGATGCA -> ACGGGATGCAA
ACGGGATGCAA -> CGGGATGCAAC
CGGGATGCAAC -> GGGATGCAACT
GGGATGCAACT -> GGATGCAACTG
GGATGCAACTG -> GATGCAACTGT
GATGCAACTGT -> ATGCAACTGTA
ATGCAACTGTA -> TGCAACTGTAG
TGCAACTGTAG -> GCAACTGTAGA
GCAACTGTAGA -> CAACTGTAGAG
CAACTGTAGAG -> AACTGTAGAGC
AACTGTAGAGC -> ACTGTAGAGCC
ACTGTAGAGCC -> CTGTAGAGCCA
CTGTAGAGCCA -> TGTAGAGCCAT
TGTAGAGCCAT -> GTAGAGCCATG
GTAGAGCCATG -> TAGAGCCATGA
TAGAGCCATGA -> AGAGCCATGAT
AGAGCCATGAT -> GAGCCATGATT
GAGCCATGATT -> AGCCATGATTT
AGCCATGATTT -> GCCATGATTTA
GCCATGATTTA -> CCATGATTTAC
CCATGATTTAC -> CATGATTTACA
CATGATTTACA -> ATGATTTACAT
ATGATTTACAT -> TGATTTACATA
TGATTTACATA -> GATTTACATAT
GATTTACATAT -> ATTTACATATT
ATTTACATATT -> TTTACATATTC
TTTACATATTC -> TTACATATTCC
TTACATATTCC -> TACATATTCCA
TACATATTCCA -> ACATATTCCAG
ACATATTCCAG -> CATATTCCAGC
CATATTCCAGC -> ATATTCCAGCT
ATATTCCAGCT -> TATTCCAGCTC
TATTCCAGCTC -> ATTCCAGCTCT
ATTCCAGCTCT -> TTCCAGCTCTA
TTCCAGCTCTA -> TCCAGCTCTAG
TCCAGCTCTAG -> CCAGCTCTAGT
CCAGCTCTAGT -> CAGCTCTAGTC
CAGCTCTAGTC -> AGCTCTAGTCG
AGCTCTAGTCG -> GCTCTAGTCGT
GCTCTAGTCGT -> CTCTAGTCGTC
CTCTAGTCGTC -> TCTAGTCGTCG
TCTAGTCGTCG -> CTAGTCGTCGT
CTAGTCGTCGT -> TAGTCGTCGTA
TAGTCGTCGTA -> AGTCGTCGTAC
AGTCGTCGTAC -> GTCGTCGTACT
GTCGTCGTACT -> TCGTCGTACTT
TCGTCGTACTT -> CGTCGTACTTT
CGTCGTACTTT -> GTCGTACTTTC
GTCGTACTTTC -> TCGTACTTTCG
TCGTACTTTCG -> CGTACTTTCGT
CGTACTTTCGT -> GTACTTTCGTC
GTACTTTCGTC -> TACTTTCGTCA
TACTTTCGTCA -> ACTTTCGTCAC
ACTTTCGTCAC -> CTTTCGTCACA
CTTTCGTCACA -> TTTCGTCACAC
TTTCGTCACAC -> TTCGTCACACC
TTCGTCACACC -> TCGTCACACCA
TCGTCACACCA -> CGTCACACCAC
CGTCACACCAC -> GTCACACCACT
GTCACACCACT -> TCACACCACTT
TCACACCACTT -> CACACCACTTT
CACACCACTTT -> ACACCACTTTC
ACACCACTTTC -> CACCACTTTCA
CACCACTTTCA -> ACCACTTTCAC
ACCACTTTCAC -> CCACTTTCACC
CCACTTTCACC -> CACTTTCACCT
CACTTTCACCT -> ACTTTCACCTC
ACTTTCACCTC -> CTTTCACCTCG
CTTTCACCTCG -> TTTCACCTCGT
TTTCACCTCGT -> TTCACCTCGTT
TTCACCTCGTT -> TCACCTCGTTC
TCACCTCGTTC -> CACCTCGTTCA
CACCTCGTTCA -> ACCTCGTTCAA
ACCTCGTTCAA -> CCTCGTTCAAG
CCTCGTTCAAG -> CTCGTTCAAGT
CTCGTTCAAGT -> TCGTTCAAGTG
TCGTTCAAGTG -> CGTTCAAGTGA
CGTTCAAGTGA -> GTTCAAGTGAT
GTTCAAGTGAT -> TTCAAGTGATT
TTCAAGTGATT -> TCAAGTGATTG
TCAAGTGATTG -> CAAGTGATTGT
CAAGTGATTGT -> AAGTGATTGTT
AAGTGATTGTT -> AGTGATTGTTC
AGTGATTGTTC -> GTGATTGTTCC
GTGATTGTTCC -> TGATTGTTCCG
TGATTGTTCCG -> GATTGTTCCGC
GATTGTTCCGC -> ATTGTTCCGCT
ATTGTTCCGCT -> TTGTTCCGCTG
TTGTTCCGCTG -> TGTTCCGCTGA
TGTTCCGCTGA -> GTTCCGCTGAG
GTTCCGCTGAG -> TTCCGCTGAGC
TTCCGCTGAGC -> TCCGCTGAGCG
TCCGCTGAGCG -> CCGCTGAGCGT
CCGCTGAGCGT -> CGCTGAGCGTT
CGCTGAGCGTT -> GCTGAGCGTTT
GCTGAGCGTTT -> CTGAGCGTTTC
CTGAGCGTTTC -> TGAGCGTTTCA
TGAGCGTTTCA -> GAGCGTTTCAT
GAGCGTTTCAT -> AGCGTTTCATA
AGCGTTTCATA -> GCGTTTCATAT
GCGTTTCATAT -> CGTTTCATATA
CGTTTCATATA -> GTTTCATATAT
GTTTCATATAT -> TTTCATATATC
TTTCATATATC -> TTCATATATCT
TTCATATATCT -> TCATATATCTA
TCATATATCTA -> CATATATCTAC
CATATATCTAC -> ATATATCTACC
ATATATCTACC -> TATATCTACCA
TATATCTACCA -> ATATCTACCAG
ATATCTACCAG -> TATCTACCAGG
TATCTACCAGG -> ATCTACCAGGT
ATCTACCAGGT -> TCTACCAGGTA
TCTACCAGGTA -> CTACCAGGTAC
CTACCAGGTAC -> TACCAGGTACT
TACCAGGTACT -> ACCAGGTACTT
ACCAGGTACTT -> CCAGGTACTTC
CCAGGTACTTC -> CAGGTACTTCT
CAGGTACTTCT -> AGGTACTTCTG
AGGTACTTCTG -> GGTACTTCTGA
GGTACTTCTGA -> GTACTTCTGAG
GTACTTCTGAG -> TACTTCTGAGG
TACTTCTGAGG -> ACTTCTGAGGC
ACTTCTGAGGC -> CTTCTGAGGCC
CTTCTGAGGCC -> TTCTGAGGCCC
TTCTGAGGCCC -> TCTGAGGCCCT
TCTGAGGCCCT -> CTGAGGCCCTT
CTGAGGCCCTT -> TGAGGCCCTTT
TGAGGCCCTTT -> GAGGCCCTTTG
GAGGCCCTTTG -> AGGCCCTTTGA
AGGCCCTTTGA -> GGCCCTTTGAC
GGCCCTTTGAC -> GCCCTTTGACG
GCCCTTTGACG -> CCCTTTGACGC
CCCTTTGACGC -> CCTTTGACGCC
CCTTTGACGCC -> CTTTGACGCCA
CTTTGACGCCA -> TTTGACGCCAG
TTTGACGCCAG -> TTGACGCCAGC
TTGACGCCAGC -> TGACGCCAGCG
GACGCCAGCGT -> ACGCCAGCGTA
ACGCCAGCGTA -> CGCCAGCGTAG
CGCCAGCGTAG -> GCCAGCGTAGA
GCCAGCGTAGA -> CCAGCGTAGAC
CCAGCGTAGAC -> CAGCGTAGACG
CAGCGTAGACG -> AGCGTAGACGA
AGCGTAGACGA -> GCGTAGACGAC
GCGTAGACGAC -> CGTAGACGACC
CGTAGACGACC -> GTAGACGACCA
GTAGACGACCA -> TAGACGACCAC
TAGACGACCAC -> AGACGACCACT
AGACGACCACT -> GACGACCACTG
GACGACCACTG -> ACGACCACTGG
ACGACCACTGG -> CGACCACTGGC
CGACCACTGGC -> GACCACTGGCG
GACCACTGGCG -> ACCACTGGCGG
ACCACTGGCGG -> CCACTGGCGGA
CCACTGGCGGA -> CACTGGCGGAG
CACTGGCGGAG -> ACTGGCGGAGC
ACTGGCGGAGC -> CTGGCGGAGCT
CTGGCGGAGCT -> TGGCGGAGCTG
TGGCGGAGCTG -> GGCGGAGCTGG
GGCGGAGCTGG -> GCGGAGCTGGG
GCGGAGCTGGG -> CGGAGCTGGGA
CGGAGCTGGGA -> GGAGCTGGGAC
GGAGCTGGGAC -> GAGCTGGGACT
GAGCTGGGACT -> AGCTGGGACTC
AGCTGGGACTC -> GCTGGGACTCC
GCTGGGACTCC -> CTGGGACTCCT
CTGGGACTCCT -> TGGGACTCCTC
TGGGACTCCTC -> GGGACTCCTCC
GGGACTCCTCC -> GGACTCCTCCT
GGACTCCTCCT -> GACTCCTCCTG
GACTCCTCCTG -> ACTCCTCCTGA
ACTCCTCCTGA -> CTCCTCCTGAG
CTCCTCCTGAG -> TCCTCCTGAGA
TCCTCCTGAGA -> CCTCCTGAGAC
CCTCCTGAGAC -> CTCCTGAGACG
CTCCTGAGACG -> TCCTGAGACGA
TCCTGAGACGA -> CCTGAGACGAC
CCTGAGACGAC -> CTGAGACGACG
CTGAGACGACG -> TGAGACGACGA
TGAGACGACGA -> GAGACGACGAT
GAGACGACGAT -> AGACGACGATG
AGACGACGATG -> GACGACGATGG
GACGACGATGG -> ACGACGATGGG
ACGACGATGGG -> CGACGATGGGC
CGACGATGGGC -> GACGATGGGCC
GACGATGGGCC -> ACGATGGGCCG
ACGATGGGCCG -> CGATGGGCCGC
CGATGGGCCGC -> GATGGGCCGCG
GATGGGCCGCG -> ATGGGCCGCGG
ATGGGCCGCGG -> TGGGCCGCGGA
TGGGCCGCGGA -> GGGCCGCGGAT
GGGCCGCGGAT -> GGCCGCGGATG
GGCCGCGGATG -> GCCGCGGATGA
GCCGCGGATGA -> CCGCGGATGAA
CCGCGGATGAA -> CGCGGATGAAA
CGCGGATGAAA -> GCGGATGAAAC
GCGGATGAAAC -> CGGATGAAACG
CGGATGAAACG -> GGATGAAACGA
GGATGAAACGA -> GATGAAACGAT
GATGAAACGAT -> ATGAAACGATC
ATGAAACGATC -> TGAAACGATCC
TGAAACGATCC -> GAAACGATCCG
GAAACGATCCG -> AAACGATCCGG
AAACGATCCGG -> AACGATCCGGG
AACGATCCGGG -> ACGATCCGGGG
ACGATCCGGGG -> CGATCCGGGGA
CGATCCGGGGA -> GATCCGGGGAG
GATCCGGGGAG -> ATCCGGGGAGT
ATCCGGGGAGT -> TCCGGGGAGTG
TCCGGGGAGTG -> CCGGGGAGTGA
CCGGGGAGTGA -> CGGGGAGTGAG
CGGGGAGTGAG -> GGGGAGTGAGA
GGGGAGTGAGA -> GGGAGTGAGAC
GGGAGTGAGAC -> GGAGTGAGACT
GGAGTGAGACT -> GAGTGAGACTT
GAGTGAGACTT -> AGTGAGACTTG
AGTGAGACTTG -> GTGAGACTTGC
GTGAGACTTGC -> TGAGACTTGCC
TGAGACTTGCC -> GAGACTTGCCC
GAGACTTGCCC -> AGACTTGCCCA
AGACTTGCCCA -> GACTTGCCCAT
GACTTGCCCAT -> ACTTGCCCATC
ACTTGCCCATC -> CTTGCCCATCC
CTTGCCCATCC -> TTGCCCATCCA
TTGCCCATCCA -> TGCCCATCCAA
TGCCCATCCAA -> GCCCATCCAAT
GCCCATCCAAT -> CCCATCCAATG
CCCATCCAATG -> CCATCCAATGG
CCATCCAATGG -> CATCCAATGGC
CATCCAATGGC -> ATCCAATGGCC
ATCCAATGGCC -> TCCAATGGCCA
TCCAATGGCCA -> CCAATGGCCAT
CCAATGGCCAT -> CAATGGCCATC
CAATGGCCATC -> AATGGCCATCA
AATGGCCATCA -> ATGGCCATCAT
ATGGCCATCAT -> TGGCCATCATG
TGGCCATCATG -> GGCCATCATGC
GGCCATCATGC -> GCCATCATGCC
GCCATCATGCC -> CCATCATGCCC
CCATCATGCCC -> CATCATGCCCC
CATCATGCCCC -> ATCATGCCCCA
ATCATGCCCCA -> TCATGCCCCAC
TCATGCCCCAC -> CATGCCCCACG
CATGCCCCACG -> ATGCCCCACGT
ATGCCCCACGT -> TGCCCCACGTC
TGCCCCACGTC -> GCCCCACGTCT
GCCCCACGTCT -> CCCCACGTCTG
CCCCACGTCTG -> CCCACGTCTGC
CCCACGTCTGC -> CCACGTCTGCA
CCACGTCTGCA -> CACGTCTGCAC
CACGTCTGCAC -> ACGTCTGCACT
ACGTCTGCACT -> CGTCTGCACTT
CGTCTGCACTT -> GTCTGCACTTT
GTCTGCACTTT -> TCTGCACTTTT
TCTGCACTTTT -> CTGCACTTTTT
CTGCACTTTTT -> TGCACTTTTTG
TGCACTTTTTG -> GCACTTTTTGT
GCACTTTTTGT -> CACTTTTTGTG
CACTTTTTGTG -> ACTTTTTGTGT
ACTTTTTGTGT -> CTTTTTGTGTG
CTTTTTGTGTG -> TTTTTGTGTGA
TTTTTGTGTGA -> TTTTGTGTGAA
TTTTGTGTGAA -> TTTGTGTGAAG
TTTGTGTGAAG -> TTGTGTGAAGC
TTGTGTGAAGC -> TGTGTGAAGCA
TGTGTGAAGCA -> GTGTGAAGCAC
GTGTGAAGCAC -> TGTGAAGCACA
TGTGAAGCACA -> GTGAAGCACAC
GTGAAGCACAC -> TGAAGCACACC
TGAAGCACACC -> GAAGCACACCG
GAAGCACACCG -> AAGCACACCGT
AAGCACACCGT -> AGCACACCGTA
AGCACACCGTA -> GCACACCGTAC
GCACACCGTAC -> CACACCGTACA
CACACCGTACA -> ACACCGTACAC
ACACCGTACAC -> CACCGTACACG
CACCGTACACG -> ACCGTACACGG
ACCGTACACGG -> CCGTACACGGT
CCGTACACGGT -> CGTACACGGTA
CGTACACGGTA -> GTACACGGTAC
GTACACGGTAC -> TACACGGTACC
TACACGGTACC -> ACACGGTACCA
ACACGGTACCA -> CACGGTACCAG
CACGGTACCAG -> ACGGTACCAGT
ACGGTACCAGT -> CGGTACCAGTA
CGGTACCAGTA -> GGTACCAGTAT
GGTACCAGTAT -> GTACCAGTATC
GTACCAGTATC -> TACCAGTATCG
TACCAGTATCG -> ACCAGTATCGC
ACCAGTATCGC -> CCAGTATCGCA
CCAGTATCGCA -> CAGTATCGCAT
CAGTATCGCAT -> AGTATCGCATG
AGTATCGCATG -> GTATCGCATGG
GTATCGCATGG -> TATCGCATGGA
TATCGCATGGA -> ATCGCATGGAG
ATCGCATGGAG -> TCGCATGGAGT
TCGCATGGAGT -> CGCATGGAGTC
CGCATGGAGTC -> GCATGGAGTCT
GCATGGAGTCT -> CATGGAGTCTT
CATGGAGTCTT -> ATGGAGTCTTT
ATGGAGTCTTT -> TGGAGTCTTTG
TGGAGTCTTTG -> GGAGTCTTTGG
GGAGTCTTTGG -> GAGTCTTTGGC
GAGTCTTTGGC -> AGTCTTTGGCG
AGTCTTTGGCG -> GTCTTTGGCGT
GTCTTTGGCGT -> TCTTTGGCGTG
TCTTTGGCGTG -> CTTTGGCGTGA
CTTTGGCGTGA -> TTTGGCGTGAT
TTTGGCGTGAT -> TTGGCGTGATT
TTGGCGTGATT -> TGGCGTGATTA
TGGCGTGATTA -> GGCGTGATTAA
GGCGTGATTAA -> GCGTGATTAAA
GCGTGATTAAA -> CGTGATTAAAT
CGTGATTAAAT -> GTGATTAAATA
GTGATTAAATA -> TGATTAAATAG
TGATTAAATAG -> GATTAAATAGG
GATTAAATAGG -> ATTAAATAGGG
ATTAAATAGGG -> TTAAATAGGGC
TTAAATAGGGC -> TAAATAGGGCA
TAAATAGGGCA -> AAATAGGGCAG
AAATAGGGCAG -> AATAGGGCAGA
AATAGGGCAGA -> ATAGGGCAGAC
ATAGGGCAGAC -> TAGGGCAGACA
TAGGGCAGACA -> AGGGCAGACAT
AGGGCAGACAT -> GGGCAGACATG
GGGCAGACATG -> GGCAGACATGA
GGCAGACATGA -> GCAGACATGAT
GCAGACATGAT -> CAGACATGATA
CAGACATGATA -> AGACATGATAG
AGACATGATAG -> GACATGATAGG
GACATGATAGG -> ACATGATAGGC
ACATGATAGGC -> CATGATAGGCC
CATGATAGGCC -> ATGATAGGCCG
ATGATAGGCCG -> TGATAGGCCGC
TGATAGGCCGC -> GATAGGCCGCG
GATAGGCCGCG -> ATAGGCCGCGC
ATAGGCCGCGC -> TAGGCCGCGCT
TAGGCCGCGCT -> AGGCCGCGCTG
AGGCCGCGCTG -> GGCCGCGCTGA
GGCCGCGCTGA -> GCCGCGCTGAC
GCCGCGCTGAC -> CCGCGCTGACG
CCGCGCTGACG -> CGCGCTGACGC
CGCGCTGACGC -> GCGCTGACGCG
GCGCTGACGCG -> CGCTGACGCGC
CGCTGACGCGC -> GCTGACGCGCG
GCTGACGCGCG -> CTGACGCGCGT
CTGACGCGCGT -> TGACGCGCGTA
TGACGCGCGTA -> GACGCGCGTAA
GACGCGCGTAA -> ACGCGCGTAAC
ACGCGCGTAAC -> CGCGCGTAACG
CGCGCGTAACG -> GCGCGTAACGT
GCGCGTAACGT -> CGCGTAACGTA
CGCGTAACGTA -> GCGTAACGTAA
GCGTAACGTAA -> CGTAACGTAAG
CGTAACGTAAG -> GTAACGTAAGC
GTAACGTAAGC -> TAACGTAAGCA
TAACGTAAGCA -> AACGTAAGCAG
AACGTAAGCAG -> ACGTAAGCAGC
ACGTAAGCAGC -> CGTAAGCAGCA
CGTAAGCAGCA -> GTAAGCAGCAG
GTAAGCAGCAG -> TAAGCAGCAGG
TAAGCAGCAGG -> AAGCAGCAGGT
AAGCAGCAGGT -> AGCAGCAGGTC
AGCAGCAGGTC -> GCAGCAGGTCT
GCAGCAGGTCT -> CAGCAGGTCTA
CAGCAGGTCTA -> AGCAGGTCTAA
AGCAGGTCTAA -> GCAGGTCTAAT
GCAGGTCTAAT -> CAGGTCTAATT
CAGGTCTAATT -> AGGTCTAATTA
AGGTCTAATTA -> GGTCTAATTAT
GGTCTAATTAT -> GTCTAATTATT
GTCTAATTATT -> TCTAATTATTT
TCTAATTATTT -> CTAATTATTTA
CTAATTATTTA -> TAATTATTTAC
TAATTATTTAC -> AATTATTTACT
AATTATTTACT -> ATTATTTACTA
ATTATTTACTA -> TTATTTACTAC
TTATTTACTAC -> TATTTACTACG
TATTTACTACG -> ATTTACTACGG
ATTTACTACGG -> TTTACTACGGT
TTTACTACGGT -> TTACTACGGTG
TTACTACGGTG -> TACTACGGTGT
TACTACGGTGT -> ACTACGGTGTG
ACTACGGTGTG -> CTACGGTGTGC
CTACGGTGTGC -> TACGGTGTGCT
TACGGTGTGCT -> ACGGTGTGCTG
ACGGTGTGCTG -> CGGTGTGCTGG
CGGTGTGCTGG -> GGTGTGCTGGT
GGTGTGCTGGT -> GTGTGCTGGTC
GTGTGCTGGTC -> TGTGCTGGTCT
TGTGCTGGTCT -> GTGCTGGTCTG
GTGCTGGTCTG -> TGCTGGTCTGG
TGCTGGTCTGG -> GCTGGTCTGGA
GCTGGTCTGGA -> CTGGTCTGGAC
CTGGTCTGGAC -> TGGTCTGGACG
TGGTCTGGACG -> GGTCTGGACGA
GGTCTGGACGA -> GTCTGGACGAG
GTCTGGACGAG -> TCTGGACGAGA
TCTGGACGAGA -> CTGGACGAGAA
CTGGACGAGAA -> TGGACGAGAAG
TGGACGAGAAG -> GGACGAGAAGA
GGACGAGAAGA -> GACGAGAAGAG
GACGAGAAGAG -> ACGAGAAGAGC
ACGAGAAGAGC -> CGAGAAGAGCA
CGAGAAGAGCA -> GAGAAGAGCAC
GAGAAGAGCAC -> AGAAGAGCACC
AGAAGAGCACC -> GAAGAGCACCG
GAAGAGCACCG -> AAGAGCACCGC
AAGAGCACCGC -> AGAGCACCGCC
AGAGCACCGCC -> GAGCACCGCCA
GAGCACCGCCA -> AGCACCGCCAG
AGCACCGCCAG -> GCACCGCCAGG
GCACCGCCAGG -> CACCGCCAGGA
CACCGCCAGGA -> ACCGCCAGGAA
ACCGCCAGGAA -> CCGCCAGGAAT
CCGCCAGGAAT -> CGCCAGGAATT
CGCCAGGAATT -> GCCAGGAATTG
GCCAGGAATTG -> CCAGGAATTGA
CCAGGAATTGA -> CAGGAATTGAT
CAGGAATTGAT -> AGGAATTGATT
AGGAATTGATT -> GGAATTGATTG
GGAATTGATTG -> GAATTGATTGC
GAATTGATTGC -> AATTGATTGCC
AATTGATTGCC -> ATTGATTGCCG
ATTGATTGCCG -> TTGATTGCCGC
TTGATTGCCGC -> TGATTGCCGCT
TGATTGCCGCT -> GATTGCCGCTC
GATTGCCGCTC -> ATTGCCGCTCT
ATTGCCGCTCT -> TTGCCGCTCTA
TTGCCGCTCTA -> TGCCGCTCTAG
TGCCGCTCTAG -> GCCGCTCTAGA
GCCGCTCTAGA -> CCGCTCTAGAT
CCGCTCTAGAT -> CGCTCTAGATT
CGCTCTAGATT -> GCTCTAGATTC
GCTCTAGATTC -> CTCTAGATTCC
CTCTAGATTCC -> TCTAGATTCCA
TCTAGATTCCA -> CTAGATTCCAC
CTAGATTCCAC -> TAGATTCCACT
TAGATTCCACT -> AGATTCCACTG
AGATTCCACTG -> GATTCCACTGA
GATTCCACTGA -> ATTCCACTGAT
ATTCCACTGAT -> TTCCACTGATT
TTCCACTGATT -> TCCACTGATTC
TCCACTGATTC -> CCACTGATTCG
CCACTGATTCG -> CACTGATTCGG
CACTGATTCGG -> ACTGATTCGGA
ACTGATTCGGA -> CTGATTCGGAC
CTGATTCGGAC -> TGATTCGGACG
TGATTCGGACG -> GATTCGGACGG
GATTCGGACGG -> ATTCGGACGGA
ATTCGGACGGA -> TTCGGACGGAT
TTCGGACGGAT -> TCGGACGGATT
TCGGACGGATT -> CGGACGGATTC
CGGACGGATTC -> GGACGGATTCG
GGACGGATTCG -> GACGGATTCGC
GACGGATTCGC -> ACGGATTCGCG
ACGGATTCGCG -> CGGATTCGCGT
CGGATTCGCGT -> GGATTCGCGTG
GGATTCGCGTG -> GATTCGCGTGT
GATTCGCGTGT -> ATTCGCGTGTG
ATTCGCGTGTG -> TTCGCGTGTGT
TTCGCGTGTGT -> TCGCGTGTGTG
TCGCGTGTGTG -> CGCGTGTGTGT
CGCGTGTGTGT -> GCGTGTGTGTC
GCGTGTGTGTC -> CGTGTGTGTCG
CGTGTGTGTCG -> GTGTGTGTCGT
GTGTGTGTCGT -> TGTGTGTCGTA
TGTGTGTCGTA -> GTGTGTCGTAG
GTGTGTCGTAG -> TGTGTCGTAGC
TGTGTCGTAGC -> GTGTCGTAGCG
GTGTCGTAGCG -> TGTCGTAGCGC
TGTCGTAGCGC -> GTCGTAGCGCG
GTCGTAGCGCG -> TCGTAGCGCGA
TCGTAGCGCGA -> CGTAGCGCGAC
CGTAGCGCGAC -> GTAGCGCGACC
GTAGCGCGACC -> TAGCGCGACCG
TAGCGCGACCG -> AGCGCGACCGC
AGCGCGACCGC -> GCGCGACCGCT
GCGCGACCGCT -> CGCGACCGCTT
CGCGACCGCTT -> GCGACCGCTTA
GCGACCGCTTA -> CGACCGCTTAT
CGACCGCTTAT -> GACCGCTTATG
GACCGCTTATG -> ACCGCTTATGT
ACCGCTTATGT -> CCGCTTATGTT
CCGCTTATGTT -> CGCTTATGTTT
CGCTTATGTTT -> GCTTATGTTTC
GCTTATGTTTC -> CTTATGTTTCG
CTTATGTTTCG -> TTATGTTTCGG
TTATGTTTCGG -> TATGTTTCGGC
TATGTTTCGGC -> ATGTTTCGGCG
ATGTTTCGGCG -> TGTTTCGGCGG
TGTTTCGGCGG -> GTTTCGGCGGA
GTTTCGGCGGA -> TTTCGGCGGAG
TTTCGGCGGAG -> TTCGGCGGAGT
TTCGGCGGAGT -> TCGGCGGAGTA
TCGGCGGAGTA -> CGGCGGAGTAA
CGGCGGAGTAA -> GGCGGAGTAAT
GGCGGAGTAAT -> GCGGAGTAATA
GCGGAGTAATA -> CGGAGTAATAC
CGGAGTAATAC -> GGAGTAATACA
GGAGTAATACA -> GAGTAATACAC
GAGTAATACAC -> AGTAATACACG
AGTAATACACG -> GTAATACACGC
GTAATACACGC -> TAATACACGCC
TAATACACGCC -> AATACACGCCG
AATACACGCCG -> ATACACGCCGA
ATACACGCCGA -> TACACGCCGAG
TACACGCCGAG -> ACACGCCGAGG
ACACGCCGAGG -> CACGCCGAGGA
CACGCCGAGGA -> ACGCCGAGGAC
ACGCCGAGGAC -> CGCCGAGGACC
CGCCGAGGACC -> GCCGAGGACCC
GCCGAGGACCC -> CCGAGGACCCG
CCGAGGACCCG -> CGAGGACCCGT
CGAGGACCCGT -> GAGGACCCGTA
GAGGACCCGTA -> AGGACCCGTAC
AGGACCCGTAC -> GGACCCGTACT
GGACCCGTACT -> GACCCGTACTC
GACCCGTACTC -> ACCCGTACTCT
ACCCGTACTCT -> CCCGTACTCTG
CCCGTACTCTG -> CCGTACTCTGT
CCGTACTCTGT -> CGTACTCTGTT
CGTACTCTGTT -> GTACTCTGTTA
GTACTCTGTTA -> TACTCTGTTAT
TACTCTGTTAT -> ACTCTGTTATC
ACTCTGTTATC -> CTCTGTTATCA
CTCTGTTATCA -> TCTGTTATCAC
TCTGTTATCAC -> CTGTTATCACA
CTGTTATCACA -> TGTTATCACAG
TGTTATCACAG -> GTTATCACAGG
GTTATCACAGG -> TTATCACAGGC
TTATCACAGGC -> TATCACAGGCT
TATCACAGGCT -> ATCACAGGCTC
ATCACAGGCTC -> TCACAGGCTCT
TCACAGGCTCT -> CACAGGCTCTA
CACAGGCTCTA -> ACAGGCTCTAT
ACAGGCTCTAT -> CAGGCTCTATA
CAGGCTCTATA -> AGGCTCTATAC
AGGCTCTATAC -> GGCTCTATACG
GGCTCTATACG -> GCTCTATACGG
GCTCTATACGG -> CTCTATACGGT
CTCTATACGGT -> TCTATACGGTC
TCTATACGGTC -> CTATACGGTCT
CTATACGGTCT -> TATACGGTCTC
TATACGGTCTC -> ATACGGTCTCA
ATACGGTCTCA -> TACGGTCTCAC
TACGGTCTCAC -> ACGGTCTCACC
ACGGTCTCACC -> CGGTCTCACCA
CGGTCTCACCA -> GGTCTCACCAA
GGTCTCACCAA -> GTCTCACCAAA
GTCTCACCAAA -> TCTCACCAAAC
TCTCACCAAAC -> CTCACCAAACT
CTCACCAAACT -> TCACCAAACTC
TCACCAAACTC -> CACCAAACTCA
CACCAAACTCA -> ACCAAACTCAG
ACCAAACTCAG -> CCAAACTCAGA
CCAAACTCAGA -> CAAACTCAGAG
CAAACTCAGAG -> AAACTCAGAGA
AAACTCAGAGA -> AACTCAGAGAA
AACTCAGAGAA -> ACTCAGAGAAA
ACTCAGAGAAA -> CTCAGAGAAAT
CTCAGAGAAAT -> TCAGAGAAATC
TCAGAGAAATC -> CAGAGAAATCT
CAGAGAAATCT -> AGAGAAATCTC
AGAGAAATCTC -> GAGAAATCTCC
GAGAAATCTCC -> AGAAATCTCCG
AGAAATCTCCG -> GAAATCTCCGT
GAAATCTCCGT -> AAATCTCCGTC
AAATCTCCGTC -> AATCTCCGTCC
AATCTCCGTCC -> ATCTCCGTCCG
ATCTCCGTCCG -> TCTCCGTCCGC
TCTCCGTCCGC -> CTCCGTCCGCT
CTCCGTCCGCT -> TCCGTCCGCTT
TCCGTCCGCTT -> CCGTCCGCTTT
CCGTCCGCTTT -> CGTCCGCTTTC
CGTCCGCTTTC -> GTCCGCTTTCA
GTCCGCTTTCA -> TCCGCTTTCAG
TCCGCTTTCAG -> CCGCTTTCAGG
CCGCTTTCAGG -> CGCTTTCAGGA
CGCTTTCAGGA -> GCTTTCAGGAT
GCTTTCAGGAT -> CTTTCAGGATA
CTTTCAGGATA -> TTTCAGGATAT
TTTCAGGATAT -> TTCAGGATATC
TTCAGGATATC -> TCAGGATATCG
TCAGGATATCG -> CAGGATATCGG
CAGGATATCGG -> AGGATATCGGA
AGGATATCGGA -> GGATATCGGAG
GGATATCGGAG -> GATATCGGAGC
GATATCGGAGC -> ATATCGGAGCC
ATATCGGAGCC -> TATCGGAGCCG
TATCGGAGCCG -> ATCGGAGCCGA
ATCGGAGCCGA -> TCGGAGCCGAG
TCGGAGCCGAG -> CGGAGCCGAGT
CGGAGCCGAGT -> GGAGCCGAGTC
GGAGCCGAGTC -> GAGCCGAGTCC
GAGCCGAGTCC -> AGCCGAGTCCC
AGCCGAGTCCC -> GCCGAGTCCCC
GCCGAGTCCCC -> CCGAGTCCCCT
CCGAGTCCCCT -> CGAGTCCCCTC
CGAGTCCCCTC -> GAGTCCCCTCC
GAGTCCCCTCC -> AGTCCCCTCCA
AGTCCCCTCCA -> GTCCCCTCCAT
GTCCCCTCCAT -> TCCCCTCCATG
TCCCCTCCATG -> CCCCTCCATGA
CCCCTCCATGA -> CCCTCCATGAA
CCCTCCATGAA -> CCTCCATGAAA
CCTCCATGAAA -> CTCCATGAAAC
CTCCATGAAAC -> TCCATGAAACA
TCCATGAAACA -> CCATGAAACAT
CCATGAAACAT -> CATGAAACATC
CATGAAACATC -> ATGAAACATCC
ATGAAACATCC -> TGAAACATCCC
