TGTTAAGTGTTCCTTCGCT -> GTTAAGTGTTCCTTCGCTA
GTTAAGTGTTCCTTCGCTA -> TTAAGTGTTCCTTCGCTAG
TCGGATAAAATAACGATGT -> CGGATAAAATAACGATGTT
CGGATAAAATAACGATGTT -> GGATAAAATAACGATGTTG
AATGGAATACCTGTCCCGC -> ATGGAATACCTGTCCCGCA
ATGGAATACCTGTCCCGCA -> TGGAATACCTGTCCCGCAC
CCTCGCCTGAGCGCTTGAG -> CTCGCCTGAGCGCTTGAGA
CTCGCCTGAGCGCTTGAGA -> TCGCCTGAGCGCTTGAGAA
GGAATACTCCGAGTCCGCA -> GAATACTCCGAGTCCGCAG
GAATACTCCGAGTCCGCAG -> AATACTCCGAGTCCGCAGG
ACGGGGGACAAGCCTGAGT -> CGGGGGACAAGCCTGAGTG
CGGGGGACAAGCCTGAGTG -> GGGGGACAAGCCTGAGTGC
TCATCCCTGGTCCGAGTGC -> CATCCCTGGTCCGAGTGCA
CATCCCTGGTCCGAGTGCA -> ATCCCTGGTCCGAGTGCAA
AGTTAGCGGCGGCATAGAC -> GTTAGCGGCGGCATAGACC
GTTAGCGGCGGCATAGACC -> TTAGCGGCGGCATAGACCG
ACTTAACTAATGGTGTATT -> CTTAACTAATGGTGTATTT
CTTAACTAATGGTGTATTT -> TTAACTAATGGTGTATTTG
TTCATCCCACGGGGGACAA -> TCATCCCACGGGGGACAAG
TCATCCCACGGGGGACAAG -> CATCCCACGGGGGACAAGC
AAGTAATACCTCCTCGTAT -> AGTAATACCTCCTCGTATT
AGTAATACCTCCTCGTATT -> GTAATACCTCCTCGTATTC
GAGAAGTTGGGAATACTCC -> AGAAGTTGGGAATACTCCG
AGAAGTTGGGAATACTCCG -> GAAGTTGGGAATACTCCGA
GGTCGGAGCGGATTGCCTG -> GTCGGAGCGGATTGCCTGC
GTCGGAGCGGATTGCCTGC -> TCGGAGCGGATTGCCTGCT
GCACGGACCTAATATGCTA -> CACGGACCTAATATGCTAC
CACGGACCTAATATGCTAC -> ACGGACCTAATATGCTACA
GAGTCCCCAGTCAATGAAC -> AGTCCCCAGTCAATGAACG
AGTCCCCAGTCAATGAACG -> GTCCCCAGTCAATGAACGA
TAGCTCACAAAGAAATCTC -> AGCTCACAAAGAAATCTCG
AGCTCACAAAGAAATCTCG -> GCTCACAAAGAAATCTCGT
GGTGGACCTCTCTTACACT -> GTGGACCTCTCTTACACTG
GTGGACCTCTCTTACACTG -> TGGACCTCTCTTACACTGA
TACTTAAACTATCATCCCT -> ACTTAAACTATCATCCCTG
ACTTAAACTATCATCCCTG -> CTTAAACTATCATCCCTGG
CCCTAGGCGTAGGTTCATC -> CCTAGGCGTAGGTTCATCC
CCTAGGCGTAGGTTCATCC -> CTAGGCGTAGGTTCATCCC
ACATCGCGGATAGGCGGGG -> CATCGCGGATAGGCGGGGG
CATCGCGGATAGGCGGGGG -> ATCGCGGATAGGCGGGGGG
TAGGTTCATCCCACGGGGG -> AGGTTCATCCCACGGGGGA
AGGTTCATCCCACGGGGGA -> GGTTCATCCCACGGGGGAC
CCTAATATGCTACAAACTA -> CTAATATGCTACAAACTAT
CTAATATGCTACAAACTAT -> TAATATGCTACAAACTATC
TTCGACGCTAGCTAAGGTG -> TCGACGCTAGCTAAGGTGA
TCGACGCTAGCTAAGGTGA -> CGACGCTAGCTAAGGTGAC
CCTTCTACTCAGATCTCCA -> CTTCTACTCAGATCTCCAG
CTTCTACTCAGATCTCCAG -> TTCTACTCAGATCTCCAGG
TTCCGATTAAACTATCATC -> TCCGATTAAACTATCATCC
TCCGATTAAACTATCATCC -> CCGATTAAACTATCATCCC
CCCCGCAACCCCTAGCCTT -> CCCGCAACCCCTAGCCTTT
CCCGCAACCCCTAGCCTTT -> CCGCAACCCCTAGCCTTTA
TGTGCCGGTTACGCACATA -> GTGCCGGTTACGCACATAC
GTGCCGGTTACGCACATAC -> TGCCGGTTACGCACATACT
ATAGGTTTTGAAGGTGAAG -> TAGGTTTTGAAGGTGAAGT
TAGGTTTTGAAGGTGAAGT -> AGGTTTTGAAGGTGAAGTG
TCCGGCACTGGGACCTTCG -> CCGGCACTGGGACCTTCGG
CCGGCACTGGGACCTTCGG -> CGGCACTGGGACCTTCGGG
TTCAAGGCGAGTGACCTTG -> TCAAGGCGAGTGACCTTGG
TCAAGGCGAGTGACCTTGG -> CAAGGCGAGTGACCTTGGA
CGTTCCCCGAGTGGCACTG -> GTTCCCCGAGTGGCACTGC
GTTCCCCGAGTGGCACTGC -> TTCCCCGAGTGGCACTGCC
GCGTACTCAAACGTCGAGT -> CGTACTCAAACGTCGAGTT
CGTACTCAAACGTCGAGTT -> GTACTCAAACGTCGAGTTA
CCCGCTGGCACGACTCACA -> CCGCTGGCACGACTCACAT
CCGCTGGCACGACTCACAT -> CGCTGGCACGACTCACATT
AAAGCACGTGCCTAAAAAC -> AAGCACGTGCCTAAAAACT
AAGCACGTGCCTAAAAACT -> AGCACGTGCCTAAAAACTA
GCGCCACCCAGCCATGGCG -> CGCCACCCAGCCATGGCGA
CGCCACCCAGCCATGGCGA -> GCCACCCAGCCATGGCGAC
AAGGTGAAGTGGCCACTTC -> AGGTGAAGTGGCCACTTCG
AGGTGAAGTGGCCACTTCG -> GGTGAAGTGGCCACTTCGC
TTTAGTAATTCCGGATACT -> TTAGTAATTCCGGATACTG
TTAGTAATTCCGGATACTG -> TAGTAATTCCGGATACTGA
TATTCAAGCAATGCGTGTC -> ATTCAAGCAATGCGTGTCC
ATTCAAGCAATGCGTGTCC -> TTCAAGCAATGCGTGTCCC
GATGGTTGCTACTCTAACT -> ATGGTTGCTACTCTAACTA
ATGGTTGCTACTCTAACTA -> TGGTTGCTACTCTAACTAG
CTAAAAACTAGCACGGACC -> TAAAAACTAGCACGGACCC
TAAAAACTAGCACGGACCC -> AAAAACTAGCACGGACCCC
AGCAGGCAGGGGATACCTG -> GCAGGCAGGGGATACCTGC
GCAGGCAGGGGATACCTGC -> CAGGCAGGGGATACCTGCG
AGCACCGACTGTCTGCTCT -> GCACCGACTGTCTGCTCTA
GCACCGACTGTCTGCTCTA -> CACCGACTGTCTGCTCTAT
AAACGTCGAGTTATCCAAA -> AACGTCGAGTTATCCAAAT
AACGTCGAGTTATCCAAAT -> ACGTCGAGTTATCCAAATC
TGCGTGTCCCACCTGGTAC -> GCGTGTCCCACCTGGTACT
GCGTGTCCCACCTGGTACT -> CGTGTCCCACCTGGTACTC
AATACTCCGAGTCCGCAGG -> ATACTCCGAGTCCGCAGGG
GGAGTCTCTCATGGCGCGT -> GAGTCTCTCATGGCGCGTA
GAGTCTCTCATGGCGCGTA -> AGTCTCTCATGGCGCGTAC
ATGCTGTTTGGCTGCGTTG -> TGCTGTTTGGCTGCGTTGT
TGCTGTTTGGCTGCGTTGT -> GCTGTTTGGCTGCGTTGTA
CTCCTGGTTTAAAATATAA -> TCCTGGTTTAAAATATAAC
TCCTGGTTTAAAATATAAC -> CCTGGTTTAAAATATAACA
GCTGCGTTGTATTCCTCAA -> CTGCGTTGTATTCCTCAAG
CTGCGTTGTATTCCTCAAG -> TGCGTTGTATTCCTCAAGC
CGACAAGTTACTTGTGAAT -> GACAAGTTACTTGTGAATC
GACAAGTTACTTGTGAATC -> ACAAGTTACTTGTGAATCA
TGTCCCACCTGGTACTCGC -> GTCCCACCTGGTACTCGCG
GTCCCACCTGGTACTCGCG -> TCCCACCTGGTACTCGCGA
GAACTTTTGATGGTTGCTA -> AACTTTTGATGGTTGCTAC
AACTTTTGATGGTTGCTAC -> ACTTTTGATGGTTGCTACT
AAAACTAGCACGGACCCCA -> AAACTAGCACGGACCCCAA
AAACTAGCACGGACCCCAA -> AACTAGCACGGACCCCAAG
CGCTGGCACGACTCACATT -> GCTGGCACGACTCACATTT
GCTGGCACGACTCACATTT -> CTGGCACGACTCACATTTC
AGTATAATTCAGCTCCCTC -> GTATAATTCAGCTCCCTCG
GTATAATTCAGCTCCCTCG -> TATAATTCAGCTCCCTCGC
AGCGCTTGAGAAGTTAGCG -> GCGCTTGAGAAGTTAGCGG
GCGCTTGAGAAGTTAGCGG -> CGCTTGAGAAGTTAGCGGC
GCAGTCGGCTGGGGATAAC -> CAGTCGGCTGGGGATAACT
CAGTCGGCTGGGGATAACT -> AGTCGGCTGGGGATAACTA
CTCGCCCGTACGCCTTCCG -> TCGCCCGTACGCCTTCCGT
TCGCCCGTACGCCTTCCGT -> CGCCCGTACGCCTTCCGTG
ACATTGAACTCGGCACCAC -> CATTGAACTCGGCACCACG
CATTGAACTCGGCACCACG -> ATTGAACTCGGCACCACGG
GACTCCTATCGGGATCCTG -> ACTCCTATCGGGATCCTGC
ACTCCTATCGGGATCCTGC -> CTCCTATCGGGATCCTGCC
ATATAATGCACATCCACAT -> TATAATGCACATCCACATC
TATAATGCACATCCACATC -> ATAATGCACATCCACATCG
TCTATTTCATGCTACTAGT -> CTATTTCATGCTACTAGTT
CTATTTCATGCTACTAGTT -> TATTTCATGCTACTAGTTT
ACTAATGGTGTATTTGAAG -> CTAATGGTGTATTTGAAGA
CTAATGGTGTATTTGAAGA -> TAATGGTGTATTTGAAGAC
GCTCTCCTGGTTTAAAATA -> CTCTCCTGGTTTAAAATAT
CTCTCCTGGTTTAAAATAT -> TCTCCTGGTTTAAAATATA
GACTAACGTGATACCAACT -> ACTAACGTGATACCAACTA
ACTAACGTGATACCAACTA -> CTAACGTGATACCAACTAG
GAAGTTGGGAATACTCCGA -> AAGTTGGGAATACTCCGAG
CCCAGTCAATGAACGACTC -> CCAGTCAATGAACGACTCG
CCAGTCAATGAACGACTCG -> CAGTCAATGAACGACTCGG
ATCACCCCTAAAACGACAC -> TCACCCCTAAAACGACACG
TCACCCCTAAAACGACACG -> CACCCCTAAAACGACACGC
TACCGTAAGCTCTCCTGGT -> ACCGTAAGCTCTCCTGGTT
ACCGTAAGCTCTCCTGGTT -> CCGTAAGCTCTCCTGGTTT
CATACTGATCCTAGTCGTA -> ATACTGATCCTAGTCGTAG
ATACTGATCCTAGTCGTAG -> TACTGATCCTAGTCGTAGA
CTAGCGGTGCGAAAAATGG -> TAGCGGTGCGAAAAATGGT
TAGCGGTGCGAAAAATGGT -> AGCGGTGCGAAAAATGGTG
ATCATCACCCCTAAAACGA -> TCATCACCCCTAAAACGAC
TCATCACCCCTAAAACGAC -> CATCACCCCTAAAACGACA
ATATGCGTACTCAAACGTC -> TATGCGTACTCAAACGTCG
TATGCGTACTCAAACGTCG -> ATGCGTACTCAAACGTCGA
CCCGAGTGGCACTGCCTTA -> CCGAGTGGCACTGCCTTAT
CCGAGTGGCACTGCCTTAT -> CGAGTGGCACTGCCTTATG
AATGCACATCCACATCGCG -> ATGCACATCCACATCGCGG
ATGCACATCCACATCGCGG -> TGCACATCCACATCGCGGA
TAGTCGTAGAGCCTGTTAA -> AGTCGTAGAGCCTGTTAAG
AGTCGTAGAGCCTGTTAAG -> GTCGTAGAGCCTGTTAAGT
ACTAGCACGGACCGTGGGC -> CTAGCACGGACCGTGGGCT
CTAGCACGGACCGTGGGCT -> TAGCACGGACCGTGGGCTT
AACTATCATCCCTGGTCCC -> ACTATCATCCCTGGTCCCG, ACTATCATCCCTGGTCCCG, ACTATCATCCCTGGTCCCA
ACTATCATCCCTGGTCCCG -> CTATCATCCCTGGTCCCGC, CTATCATCCCTGGTCCCGT
CTTGTCAAACTATCATCCC -> TTGTCAAACTATCATCCCT
TTGTCAAACTATCATCCCT -> TGTCAAACTATCATCCCTG
TACTGACGGGATGGCAGCG -> ACTGACGGGATGGCAGCGG
ACTGACGGGATGGCAGCGG -> CTGACGGGATGGCAGCGGT
GTTTGTGACTGAACTTTTG -> TTTGTGACTGAACTTTTGA
TTTGTGACTGAACTTTTGA -> TTGTGACTGAACTTTTGAT
CAAACTATCATCCCTGGTC -> AAACTATCATCCCTGGTCC, AAACTATCATCCCTGGTCC
AAACTATCATCCCTGGTCC -> AACTATCATCCCTGGTCCC, AACTATCATCCCTGGTCCG, AACTATCATCCCTGGTCCC, AACTATCATCCCTGGTCCC
AATCGCCCTCGCAGTCGGC -> ATCGCCCTCGCAGTCGGCT
ATCGCCCTCGCAGTCGGCT -> TCGCCCTCGCAGTCGGCTG
CCCAGCCATGGCGACCTTC -> CCAGCCATGGCGACCTTCA
CCAGCCATGGCGACCTTCA -> CAGCCATGGCGACCTTCAA
AAAGAAATCTCGTCCTGCC -> AAGAAATCTCGTCCTGCCT
AAGAAATCTCGTCCTGCCT -> AGAAATCTCGTCCTGCCTT
CTAGCCGGTAGTTAAGGTG -> TAGCCGGTAGTTAAGGTGA
TAGCCGGTAGTTAAGGTGA -> AGCCGGTAGTTAAGGTGAG
CGCCCGATGCCCTGACTCG -> GCCCGATGCCCTGACTCGC
GCCCGATGCCCTGACTCGC -> CCCGATGCCCTGACTCGCC
CGCACCCACGAAATGAGAA -> GCACCCACGAAATGAGAAA
GCACCCACGAAATGAGAAA -> CACCCACGAAATGAGAAAA
ATCGCGGATAGGCGGGGGG -> TCGCGGATAGGCGGGGGGT
GTCCGAGTGCAACTTGTTT -> TCCGAGTGCAACTTGTTTC
TCCGAGTGCAACTTGTTTC -> CCGAGTGCAACTTGTTTCC
ATTAGTTGTGTTCCGACCT -> TTAGTTGTGTTCCGACCTT
TTAGTTGTGTTCCGACCTT -> TAGTTGTGTTCCGACCTTC
CCTGCCGTCCTCGTCTTGA -> CTGCCGTCCTCGTCTTGAA
CTGCCGTCCTCGTCTTGAA -> TGCCGTCCTCGTCTTGAAA
AATTGACTCAGCACCGACT -> ATTGACTCAGCACCGACTG
ATTGACTCAGCACCGACTG -> TTGACTCAGCACCGACTGT
TCACTGTGCCGGTTACGCA -> CACTGTGCCGGTTACGCAC
CACTGTGCCGGTTACGCAC -> ACTGTGCCGGTTACGCACA
GGACCAAGGTCGGAGCGGA -> GACCAAGGTCGGAGCGGAT
GACCAAGGTCGGAGCGGAT -> ACCAAGGTCGGAGCGGATT
GATCAACGATACGCCTGTT -> ATCAACGATACGCCTGTTG
ATCAACGATACGCCTGTTG -> TCAACGATACGCCTGTTGC
TCGCCTGAGCGCTTGAGAA -> CGCCTGAGCGCTTGAGAAG
CGCCTGAGCGCTTGAGAAG -> GCCTGAGCGCTTGAGAAGT
AACTTGTTTCCGAGGAGCC -> ACTTGTTTCCGAGGAGCCA
ACTTGTTTCCGAGGAGCCA -> CTTGTTTCCGAGGAGCCAG
CCGATTAAACTATCATCCC -> CGATTAAACTATCATCCCT
TGGAGAATTTCTAGCGGTG -> GGAGAATTTCTAGCGGTGC
GGAGAATTTCTAGCGGTGC -> GAGAATTTCTAGCGGTGCG
AGTAATTCTGAGCATATAA -> GTAATTCTGAGCATATAAG
GTAATTCTGAGCATATAAG -> TAATTCTGAGCATATAAGT
ATGTTGAATTAGCTCACAA -> TGTTGAATTAGCTCACAAA
TGTTGAATTAGCTCACAAA -> GTTGAATTAGCTCACAAAG
TAACCCGCTGGCACGACTC -> AACCCGCTGGCACGACTCA
AACCCGCTGGCACGACTCA -> ACCCGCTGGCACGACTCAC
TGTTCCTTCGCTAGCCGGT -> GTTCCTTCGCTAGCCGGTA
GTTCCTTCGCTAGCCGGTA -> TTCCTTCGCTAGCCGGTAG
TCGCGGATAGGCGGGGGGT -> CGCGGATAGGCGGGGGGTT
AGTTCTACCAATAGTTGCG -> GTTCTACCAATAGTTGCGT
GTTCTACCAATAGTTGCGT -> TTCTACCAATAGTTGCGTA
CGAAATAAGATGTTTGACT -> GAAATAAGATGTTTGACTA
GAAATAAGATGTTTGACTA -> AAATAAGATGTTTGACTAA
ACCCAGATATACACTTGCT -> CCCAGATATACACTTGCTG
CCCAGATATACACTTGCTG -> CCAGATATACACTTGCTGG
AGTACGCCTTTAGTAATTC -> GTACGCCTTTAGTAATTCC
GTACGCCTTTAGTAATTCC -> TACGCCTTTAGTAATTCCG
AACATACGACAGCGGAGGC -> ACATACGACAGCGGAGGCC
ACATACGACAGCGGAGGCC -> CATACGACAGCGGAGGCCT
ACGGACCTAATATGCTACA -> CGGACCTAATATGCTACAA
CGGACCTAATATGCTACAA -> GGACCTAATATGCTACAAA
AATGCGTGTCCCACCTGGT -> ATGCGTGTCCCACCTGGTA
ATGCGTGTCCCACCTGGTA -> TGCGTGTCCCACCTGGTAC
ACGAAATGAGAAAAGCAGA -> CGAAATGAGAAAAGCAGAA
CGAAATGAGAAAAGCAGAA -> GAAATGAGAAAAGCAGAAT
AACCCAGATATACACTTGC -> ACCCAGATATACACTTGCT
GACCTTCAATAGTACGCCT -> ACCTTCAATAGTACGCCTT
ACCTTCAATAGTACGCCTT -> CCTTCAATAGTACGCCTTT
CCACCTACCGAACGCTTGG -> CACCTACCGAACGCTTGGC
CACCTACCGAACGCTTGGC -> ACCTACCGAACGCTTGGCC
GTGCTTTCACTGTGCCGGT -> TGCTTTCACTGTGCCGGTT
TGCTTTCACTGTGCCGGTT -> GCTTTCACTGTGCCGGTTA
GGGGGACAAGCCTGAGTGC -> GGGGACAAGCCTGAGTGCT
AGGGGTATATTGCGACCTT -> GGGGTATATTGCGACCTTC
GGGGTATATTGCGACCTTC -> GGGTATATTGCGACCTTCT
GTTATCCAAATCGCCCTCG -> TTATCCAAATCGCCCTCGC
TTATCCAAATCGCCCTCGC -> TATCCAAATCGCCCTCGCA
TTTCGAGCCCAATAAAAAC -> TTCGAGCCCAATAAAAACT
TTCGAGCCCAATAAAAACT -> TCGAGCCCAATAAAAACTA
TGCGTTGTATTCCTCAAGC -> GCGTTGTATTCCTCAAGCC
GCGTTGTATTCCTCAAGCC -> CGTTGTATTCCTCAAGCCG
AAGCTACTTAAACTATCAT -> AGCTACTTAAACTATCATC
AGCTACTTAAACTATCATC -> GCTACTTAAACTATCATCC
TTTTGAAGGTGAAGTGGCC -> TTTGAAGGTGAAGTGGCCA
TTTGAAGGTGAAGTGGCCA -> TTGAAGGTGAAGTGGCCAC
AGGCGTAGGTTCATCCCAC -> GGCGTAGGTTCATCCCACG
GGCGTAGGTTCATCCCACG -> GCGTAGGTTCATCCCACGG
TCGAGCCCAATAAAAACTA -> CGAGCCCAATAAAAACTAG
CGAGCCCAATAAAAACTAG -> GAGCCCAATAAAAACTAGC
TGGGGAGTCTCTCATGGCG -> GGGGAGTCTCTCATGGCGC
GGGGAGTCTCTCATGGCGC -> GGGAGTCTCTCATGGCGCG
ATTCTGGTTGAACCACTGT -> TTCTGGTTGAACCACTGTC
TTCTGGTTGAACCACTGTC -> TCTGGTTGAACCACTGTCA
GCTAGCCGGTAGTTAAGGT -> CTAGCCGGTAGTTAAGGTG
GCGAAAAATGGTGGACCTC -> CGAAAAATGGTGGACCTCT
CGAAAAATGGTGGACCTCT -> GAAAAATGGTGGACCTCTC
GAGCCCAATAAAAACTAGC -> AGCCCAATAAAAACTAGCA
AACGACACGCGCTTACAAA -> ACGACACGCGCTTACAAAT
ACGACACGCGCTTACAAAT -> CGACACGCGCTTACAAATT
GCCTCGGTCGGGGAGTCCC -> CCTCGGTCGGGGAGTCCCC
CCTCGGTCGGGGAGTCCCC -> CTCGGTCGGGGAGTCCCCA
CGGCGTTCCCCGAGTGGCA -> GGCGTTCCCCGAGTGGCAC
GGCGTTCCCCGAGTGGCAC -> GCGTTCCCCGAGTGGCACT
CTCCCTCGCCTCGGTCGGG -> TCCCTCGCCTCGGTCGGGG
TCCCTCGCCTCGGTCGGGG -> CCCTCGCCTCGGTCGGGGA
ACTAGAGCAACGCACCCAC -> CTAGAGCAACGCACCCACG
CTAGAGCAACGCACCCACG -> TAGAGCAACGCACCCACGA
CCCAATTGACTCAGCACCG -> CCAATTGACTCAGCACCGA
CCAATTGACTCAGCACCGA -> CAATTGACTCAGCACCGAC
TCGAACACTCGCAATTAGT -> CGAACACTCGCAATTAGTT
CGAACACTCGCAATTAGTT -> GAACACTCGCAATTAGTTG
TCCTTCGCTAGCCGGTAGT -> CCTTCGCTAGCCGGTAGTT
CCTTCGCTAGCCGGTAGTT -> CTTCGCTAGCCGGTAGTTA
CCTCTTCTCTGATAAATAA -> CTCTTCTCTGATAAATAAT
CTCTTCTCTGATAAATAAT -> TCTTCTCTGATAAATAATC
GCCTGAGTGCTTTCACTGT -> CCTGAGTGCTTTCACTGTG
CCTGAGTGCTTTCACTGTG -> CTGAGTGCTTTCACTGTGC
TTAGCTCACAAAGAAATCT -> TAGCTCACAAAGAAATCTC
GGACCTTCGGGGCATATTA -> GACCTTCGGGGCATATTAC
GACCTTCGGGGCATATTAC -> ACCTTCGGGGCATATTACC
CTAGGCGTAGGTTCATCCC -> TAGGCGTAGGTTCATCCCA
CGATCAACGATACGCCTGT -> GATCAACGATACGCCTGTT
CCAGATATACACTTGCTGG -> CAGATATACACTTGCTGGG
CAGATATACACTTGCTGGG -> AGATATACACTTGCTGGGT
ATGGGGGTGCTGCTCCGCG -> TGGGGGTGCTGCTCCGCGA
TGGGGGTGCTGCTCCGCGA -> GGGGGTGCTGCTCCGCGAT
TCATCCCTGGTCCCGCCCG -> CATCCCTGGTCCCGCCCGA
CATCCCTGGTCCCGCCCGA -> ATCCCTGGTCCCGCCCGAT
TTCCCCGAGTGGCACTGCC -> TCCCCGAGTGGCACTGCCT
TCCCCGAGTGGCACTGCCT -> CCCCGAGTGGCACTGCCTT
GCACTGGGACCTTCGGGGC -> CACTGGGACCTTCGGGGCA
CACTGGGACCTTCGGGGCA -> ACTGGGACCTTCGGGGCAT
CTTATACATCTGTTACCGT -> TTATACATCTGTTACCGTA
TTATACATCTGTTACCGTA -> TATACATCTGTTACCGTAA
CTACCATAGCAATACACGG -> TACCATAGCAATACACGGA
TACCATAGCAATACACGGA -> ACCATAGCAATACACGGAG
TACGCCTGTTGCAAAACAT -> ACGCCTGTTGCAAAACATT
ACGCCTGTTGCAAAACATT -> CGCCTGTTGCAAAACATTG
TTCGGGGCATATTACCAGC -> TCGGGGCATATTACCAGCC
TCGGGGCATATTACCAGCC -> CGGGGCATATTACCAGCCT
GAACTCCGCGACGCCCCGC -> AACTCCGCGACGCCCCGCA
AACTCCGCGACGCCCCGCA -> ACTCCGCGACGCCCCGCAA
ATCCACATCGCGGATAGGC -> TCCACATCGCGGATAGGCG
TCCACATCGCGGATAGGCG -> CCACATCGCGGATAGGCGG
CGCAGGGACCTTCGAGAAC -> GCAGGGACCTTCGAGAACT
GCAGGGACCTTCGAGAACT -> CAGGGACCTTCGAGAACTC
TGAGCGCTTGAGAAGTTAG -> GAGCGCTTGAGAAGTTAGC
GAGCGCTTGAGAAGTTAGC -> AGCGCTTGAGAAGTTAGCG
GGGATATGCGTACTCAAAC -> GGATATGCGTACTCAAACG
GGATATGCGTACTCAAACG -> GATATGCGTACTCAAACGT
ATCCCTGGTCCCGCCCGAT -> TCCCTGGTCCCGCCCGATG
TCCCTGGTCCCGCCCGATG -> CCCTGGTCCCGCCCGATGC
CCTTCCGGACTGCGCGAGT -> CTTCCGGACTGCGCGAGTA
CTTCCGGACTGCGCGAGTA -> TTCCGGACTGCGCGAGTAG
TACCGAACGCTTGGCCAGG -> ACCGAACGCTTGGCCAGGA
ACCGAACGCTTGGCCAGGA -> CCGAACGCTTGGCCAGGAC
CGTTGTATTCCTCAAGCCG -> GTTGTATTCCTCAAGCCGG
GGGTATATTGCGACCTTCT -> GGTATATTGCGACCTTCTA
GGTATATTGCGACCTTCTA -> GTATATTGCGACCTTCTAC
GAAGTGGCCACTTCGCTGT -> AAGTGGCCACTTCGCTGTA
AAGTGGCCACTTCGCTGTA -> AGTGGCCACTTCGCTGTAC
GCCTAAAAACTAGCACGGA -> CCTAAAAACTAGCACGGAC
CCTAAAAACTAGCACGGAC -> CTAAAAACTAGCACGGACC
TAACTAGCAGGCAGGGGAT -> AACTAGCAGGCAGGGGATA
AACTAGCAGGCAGGGGATA -> ACTAGCAGGCAGGGGATAC
TGCACATCCACATCGCGGA -> GCACATCCACATCGCGGAT
CCCTCGCCTCGGTCGGGGA -> CCTCGCCTCGGTCGGGGAG
CTCGCCTCGGTCGGGGAGT -> TCGCCTCGGTCGGGGAGTC
TCGCCTCGGTCGGGGAGTC -> CGCCTCGGTCGGGGAGTCC
GACCGTAAAAACTAGCACG -> ACCGTAAAAACTAGCACGG
ACCGTAAAAACTAGCACGG -> CCGTAAAAACTAGCACGGA
CTGTCCCGCACGGCGTTCC -> TGTCCCGCACGGCGTTCCC
TGTCCCGCACGGCGTTCCC -> GTCCCGCACGGCGTTCCCC
CAATAAACCGTACCATATT -> AATAAACCGTACCATATTA
AATAAACCGTACCATATTA -> ATAAACCGTACCATATTAG
TAGTCGAACACTCGCAATT -> AGTCGAACACTCGCAATTA
AGTCGAACACTCGCAATTA -> GTCGAACACTCGCAATTAG
AGTTGGGAATACTCCGAGT -> GTTGGGAATACTCCGAGTC
GTTGGGAATACTCCGAGTC -> TTGGGAATACTCCGAGTCC
CTACCAATAGTTGCGTAGG -> TACCAATAGTTGCGTAGGG
TACCAATAGTTGCGTAGGG -> ACCAATAGTTGCGTAGGGG
TGCTGCTCCGCGATCAACG -> GCTGCTCCGCGATCAACGA
GCTGCTCCGCGATCAACGA -> CTGCTCCGCGATCAACGAT
ATTTGAAGACTCCTATCGG -> TTTGAAGACTCCTATCGGG
TTTGAAGACTCCTATCGGG -> TTGAAGACTCCTATCGGGA
CCATGGCGACCTTCAATAG -> CATGGCGACCTTCAATAGT
CATGGCGACCTTCAATAGT -> ATGGCGACCTTCAATAGTA
GCCATGTCGATTTATATAA -> CCATGTCGATTTATATAAT
CCATGTCGATTTATATAAT -> CATGTCGATTTATATAATG
GTAATACCTCCTCGTATTC -> TAATACCTCCTCGTATTCA
GCGAGCATCTTCTACTTAA -> CGAGCATCTTCTACTTAAG
CGAGCATCTTCTACTTAAG -> GAGCATCTTCTACTTAAGA
AGTGCAACTTGTTTCCGAG -> GTGCAACTTGTTTCCGAGG
GTGCAACTTGTTTCCGAGG -> TGCAACTTGTTTCCGAGGA
CCTGGTCCCGTAAAGCACG -> CTGGTCCCGTAAAGCACGT
CTGGTCCCGTAAAGCACGT -> TGGTCCCGTAAAGCACGTG
TCTTCTCTGATAAATAATC -> CTTCTCTGATAAATAATCG
ACAAACTATCATCCCTGGT -> CAAACTATCATCCCTGGTC
CAAATCGCCCTCGCAGTCG -> AAATCGCCCTCGCAGTCGG
AAATCGCCCTCGCAGTCGG -> AATCGCCCTCGCAGTCGGC
CGAGTGGCACTGCCTTATG -> GAGTGGCACTGCCTTATGC
GAGTGGCACTGCCTTATGC -> AGTGGCACTGCCTTATGCT
TTCGCTAGCCGGTAGTTAA -> TCGCTAGCCGGTAGTTAAG
TCGCTAGCCGGTAGTTAAG -> CGCTAGCCGGTAGTTAAGG
AGAATACAGATAACCCGCT -> GAATACAGATAACCCGCTG
GAATACAGATAACCCGCTG -> AATACAGATAACCCGCTGG
TCCCGTAAAGCACGTGCCT -> CCCGTAAAGCACGTGCCTA
CCCGTAAAGCACGTGCCTA -> CCGTAAAGCACGTGCCTAA
GATGTTGAATTAGCTCACA -> ATGTTGAATTAGCTCACAA
TTGTTAGCTACCCACCTAC -> TGTTAGCTACCCACCTACC
TGTTAGCTACCCACCTACC -> GTTAGCTACCCACCTACCG
TACTTAAGACATGACCAGT -> ACTTAAGACATGACCAGTA
ACTTAAGACATGACCAGTA -> CTTAAGACATGACCAGTAT
CGGTGCGAAAAATGGTGGA -> GGTGCGAAAAATGGTGGAC
GGTGCGAAAAATGGTGGAC -> GTGCGAAAAATGGTGGACC
ATGGTATGGTTTTAAAAAC -> TGGTATGGTTTTAAAAACT
TGGTATGGTTTTAAAAACT -> GGTATGGTTTTAAAAACTA
CCGAACGCTTGGCCAGGAC -> CGAACGCTTGGCCAGGACA
TAGTTGTGTTCCGACCTTC -> AGTTGTGTTCCGACCTTCC
GAATGGTATGGTTTTAAAA -> AATGGTATGGTTTTAAAAA
AATGGTATGGTTTTAAAAA -> ATGGTATGGTTTTAAAAAC
AAATTAATATGCACTTGCG -> AATTAATATGCACTTGCGA
AATTAATATGCACTTGCGA -> ATTAATATGCACTTGCGAA
TAGTAATTCTGAGCATATA -> AGTAATTCTGAGCATATAA
CTGGTCCCAGGCAGGCAAC -> TGGTCCCAGGCAGGCAACA
TGGTCCCAGGCAGGCAACA -> GGTCCCAGGCAGGCAACAT
AATAGTACGCCTTTAGTAA -> ATAGTACGCCTTTAGTAAT
ATAGTACGCCTTTAGTAAT -> TAGTACGCCTTTAGTAATT
CTGTGCCGGTTACGCACAT -> TGTGCCGGTTACGCACATA
ATTTTACTAGAGCAACGCA -> TTTTACTAGAGCAACGCAC
TTTTACTAGAGCAACGCAC -> TTTACTAGAGCAACGCACC
ACTTGTGAATCAAGCAGGG -> CTTGTGAATCAAGCAGGGC
CTTGTGAATCAAGCAGGGC -> TTGTGAATCAAGCAGGGCT
AGGACACACCCAATTGACT -> GGACACACCCAATTGACTC
GGACACACCCAATTGACTC -> GACACACCCAATTGACTCA
ACCATAGCAATACACGGAG -> CCATAGCAATACACGGAGC
TATACATCTGTTACCGTAA -> ATACATCTGTTACCGTAAG
ATACATCTGTTACCGTAAG -> TACATCTGTTACCGTAAGC
CACTGTCATACTGATCCTA -> ACTGTCATACTGATCCTAG
ACTGTCATACTGATCCTAG -> CTGTCATACTGATCCTAGT
GCCTACGGCGCCACCCAGC -> CCTACGGCGCCACCCAGCC
CCTACGGCGCCACCCAGCC -> CTACGGCGCCACCCAGCCA
GCACGACTCACATTTCTTG -> CACGACTCACATTTCTTGT
CACGACTCACATTTCTTGT -> ACGACTCACATTTCTTGTT
TGTGACTGAACTTTTGATG -> GTGACTGAACTTTTGATGG
GTGACTGAACTTTTGATGG -> TGACTGAACTTTTGATGGT
CTTCTCTGATAAATAATCG -> TTCTCTGATAAATAATCGA
TTCTCTGATAAATAATCGA -> TCTCTGATAAATAATCGAT
TAGAGCAACGCACCCACGA -> AGAGCAACGCACCCACGAA
AGAGCAACGCACCCACGAA -> GAGCAACGCACCCACGAAA
AATAATCGATTGGGGAGTC -> ATAATCGATTGGGGAGTCT
ATAATCGATTGGGGAGTCT -> TAATCGATTGGGGAGTCTC
GTCCTGCCTTCGTAGGGTA -> TCCTGCCTTCGTAGGGTAT
TCCTGCCTTCGTAGGGTAT -> CCTGCCTTCGTAGGGTATA
CCGATGCCCTGACTCGCCC -> CGATGCCCTGACTCGCCCG
CGATGCCCTGACTCGCCCG -> GATGCCCTGACTCGCCCGT
TTAACTAATGGTGTATTTG -> TAACTAATGGTGTATTTGA
TCGTAGAGCCTGTTAAGTG -> CGTAGAGCCTGTTAAGTGT
CGTAGAGCCTGTTAAGTGT -> GTAGAGCCTGTTAAGTGTT
TAAGGTGAGAACATACGAC -> AAGGTGAGAACATACGACA
AAGGTGAGAACATACGACA -> AGGTGAGAACATACGACAG
ACTGGGACCTTCGGGGCAT -> CTGGGACCTTCGGGGCATA
CTGGGACCTTCGGGGCATA -> TGGGACCTTCGGGGCATAT
AGCACGGACCTAATATGCT -> GCACGGACCTAATATGCTA
TCTACTCAGATCTCCAGGC -> CTACTCAGATCTCCAGGCA
CTACTCAGATCTCCAGGCA -> TACTCAGATCTCCAGGCAC
GTTTTAAAAACTAGCACGG -> TTTTAAAAACTAGCACGGA
TTTTAAAAACTAGCACGGA -> TTTAAAAACTAGCACGGAC
AGGCACACACGCGATCTGC -> GGCACACACGCGATCTGCA
GGCACACACGCGATCTGCA -> GCACACACGCGATCTGCAA
ACGCGATCTGCAACCCAGA -> CGCGATCTGCAACCCAGAT
CGCGATCTGCAACCCAGAT -> GCGATCTGCAACCCAGATA
AGCCAGGAACTTAACTAAT -> GCCAGGAACTTAACTAATG
GCCAGGAACTTAACTAATG -> CCAGGAACTTAACTAATGG
CTCACAAAGAAATCTCGTC -> TCACAAAGAAATCTCGTCC
TCACAAAGAAATCTCGTCC -> CACAAAGAAATCTCGTCCT
GCTCTATTTCATGCTACTA -> CTCTATTTCATGCTACTAG
CTCTATTTCATGCTACTAG -> TCTATTTCATGCTACTAGT
CTTGTTTCCGAGGAGCCAG -> TTGTTTCCGAGGAGCCAGG
TGAAGTGGCCACTTCGCTG -> GAAGTGGCCACTTCGCTGT
TAAGCTCTCCTGGTTTAAA -> AAGCTCTCCTGGTTTAAAA
AAGCTCTCCTGGTTTAAAA -> AGCTCTCCTGGTTTAAAAT
ACGGCGTTCCCCGAGTGGC -> CGGCGTTCCCCGAGTGGCA
TGGTCCGAGTGCAACTTGT -> GGTCCGAGTGCAACTTGTT
GGTCCGAGTGCAACTTGTT -> GTCCGAGTGCAACTTGTTT
GGACCGTGGGCTTGTCAAA -> GACCGTGGGCTTGTCAAAC
GACCGTGGGCTTGTCAAAC -> ACCGTGGGCTTGTCAAACT
AAGCAGGGCTGGAGAATTT -> AGCAGGGCTGGAGAATTTC
AGCAGGGCTGGAGAATTTC -> GCAGGGCTGGAGAATTTCT
TTCCGAGGAGCCAGGAACT -> TCCGAGGAGCCAGGAACTT
TCCGAGGAGCCAGGAACTT -> CCGAGGAGCCAGGAACTTA
ACACGGAGCCCCTAGGCGT -> CACGGAGCCCCTAGGCGTA
CACGGAGCCCCTAGGCGTA -> ACGGAGCCCCTAGGCGTAG
GGATAACTAATCATTTTAC -> GATAACTAATCATTTTACT
GATAACTAATCATTTTACT -> ATAACTAATCATTTTACTA
GAAAGGTTTTGAGAAGTTG -> AAAGGTTTTGAGAAGTTGG
AAAGGTTTTGAGAAGTTGG -> AAGGTTTTGAGAAGTTGGG
CACAAAGAAATCTCGTCCT -> ACAAAGAAATCTCGTCCTG
ACAAAGAAATCTCGTCCTG -> CAAAGAAATCTCGTCCTGC
GATGCTGTTTGGCTGCGTT -> ATGCTGTTTGGCTGCGTTG
CACGTTCGGTCAACGACAA -> ACGTTCGGTCAACGACAAG
ACGTTCGGTCAACGACAAG -> CGTTCGGTCAACGACAAGT
CCGGTTACGCACATACTGA -> CGGTTACGCACATACTGAA
CGGTTACGCACATACTGAA -> GGTTACGCACATACTGAAT
CCTTTAATCATCACCCCTA -> CTTTAATCATCACCCCTAA
CTTTAATCATCACCCCTAA -> TTTAATCATCACCCCTAAA
AAAATAACGATGTTGAATT -> AAATAACGATGTTGAATTA
AAATAACGATGTTGAATTA -> AATAACGATGTTGAATTAG
AACCGTACCATATTAGCCC -> ACCGTACCATATTAGCCCT
ACCGTACCATATTAGCCCT -> CCGTACCATATTAGCCCTC
ACCTTCGGGGCATATTACC -> CCTTCGGGGCATATTACCA
GTTAAGGTGAGAACATACG -> TTAAGGTGAGAACATACGA
TTAAGGTGAGAACATACGA -> TAAGGTGAGAACATACGAC
CTACCGAACGCTTGGCCAG -> TACCGAACGCTTGGCCAGG
ATATTGCGACCTTCTACTC -> TATTGCGACCTTCTACTCA
TATTGCGACCTTCTACTCA -> ATTGCGACCTTCTACTCAG
TTAAACTATCATCCCTGGT -> TAAACTATCATCCCTGGTC, TAAACTATCATCCCTGGTC
TAAACTATCATCCCTGGTC -> AAACTATCATCCCTGGTCC, AAACTATCATCCCTGGTCC
AGAAATCTCGTCCTGCCTT -> GAAATCTCGTCCTGCCTTC
GAAATCTCGTCCTGCCTTC -> AAATCTCGTCCTGCCTTCG
CTGGTACTCGCGAGCATCT -> TGGTACTCGCGAGCATCTT
TGGTACTCGCGAGCATCTT -> GGTACTCGCGAGCATCTTC
GGATAAAATAACGATGTTG -> GATAAAATAACGATGTTGA
ACCAGTATAATTCAGCTCC -> CCAGTATAATTCAGCTCCC
CCAGTATAATTCAGCTCCC -> CAGTATAATTCAGCTCCCT
AGGCAACATTTACGAAATA -> GGCAACATTTACGAAATAA
GGCAACATTTACGAAATAA -> GCAACATTTACGAAATAAG
CTACCCACCTACCGAACGC -> TACCCACCTACCGAACGCT
TACCCACCTACCGAACGCT -> ACCCACCTACCGAACGCTT
ACCACGTTCCGATTAAACT -> CCACGTTCCGATTAAACTA
CCACGTTCCGATTAAACTA -> CACGTTCCGATTAAACTAT
AGCTCCCTCGCCTCGGTCG -> GCTCCCTCGCCTCGGTCGG
GCTCCCTCGCCTCGGTCGG -> CTCCCTCGCCTCGGTCGGG
ATTAATATGCACTTGCGAA -> TTAATATGCACTTGCGAAG
CATGCTACTAGTTTGTGAC -> ATGCTACTAGTTTGTGACT
ATGCTACTAGTTTGTGACT -> TGCTACTAGTTTGTGACTG
CGTGATACCAACTAGCGAT -> GTGATACCAACTAGCGATT
GTGATACCAACTAGCGATT -> TGATACCAACTAGCGATTC
CGCGCTTACAAATTAATAT -> GCGCTTACAAATTAATATG
GCGCTTACAAATTAATATG -> CGCTTACAAATTAATATGC
CTTTCACTGTGCCGGTTAC -> TTTCACTGTGCCGGTTACG
TTTCACTGTGCCGGTTACG -> TTCACTGTGCCGGTTACGC
AAAACATTGAACTCGGCAC -> AAACATTGAACTCGGCACC
AAACATTGAACTCGGCACC -> AACATTGAACTCGGCACCA
TGAACTCGGCACCACGGTA -> GAACTCGGCACCACGGTAG
GAACTCGGCACCACGGTAG -> AACTCGGCACCACGGTAGT
TTAGCGGCGGCATAGACCG -> TAGCGGCGGCATAGACCGT
CGATGTTGAATTAGCTCAC -> GATGTTGAATTAGCTCACA
GTAGAGCCTGTTAAGTGTT -> TAGAGCCTGTTAAGTGTTC
AATACAGATAACCCGCTGG -> ATACAGATAACCCGCTGGC
ATACAGATAACCCGCTGGC -> TACAGATAACCCGCTGGCA
ACGATGTTGAATTAGCTCA -> CGATGTTGAATTAGCTCAC
GACCTTGGAATGGTATGGT -> ACCTTGGAATGGTATGGTT
ACCTTGGAATGGTATGGTT -> CCTTGGAATGGTATGGTTT
TGGTGTATTTGAAGACTCC -> GGTGTATTTGAAGACTCCT
GGTGTATTTGAAGACTCCT -> GTGTATTTGAAGACTCCTA
CGCCCTCGCAGTCGGCTGG -> GCCCTCGCAGTCGGCTGGG
GCCCTCGCAGTCGGCTGGG -> CCCTCGCAGTCGGCTGGGG
AAATGAGAAAAGCAGAATA -> AATGAGAAAAGCAGAATAC
AATGAGAAAAGCAGAATAC -> ATGAGAAAAGCAGAATACA
CGCCTTTAGTAATTCCGGA -> GCCTTTAGTAATTCCGGAT
GCCTTTAGTAATTCCGGAT -> CCTTTAGTAATTCCGGATA
GCAACATTTACGAAATAAG -> CAACATTTACGAAATAAGA
CAACATTTACGAAATAAGA -> AACATTTACGAAATAAGAT
CCTCGCCTCGGTCGGGGAG -> CTCGCCTCGGTCGGGGAGT
GCAGGCAACATTTACGAAA -> CAGGCAACATTTACGAAAT
CAGGCAACATTTACGAAAT -> AGGCAACATTTACGAAATA
TCTTGAAAGGTTTTGAGAA -> CTTGAAAGGTTTTGAGAAG
CTTGAAAGGTTTTGAGAAG -> TTGAAAGGTTTTGAGAAGT
AGCCTTTAATCATCACCCC -> GCCTTTAATCATCACCCCT
GCCTTTAATCATCACCCCT -> CCTTTAATCATCACCCCTA
ACAAGTTACTTGTGAATCA -> CAAGTTACTTGTGAATCAA
CAAGTTACTTGTGAATCAA -> AAGTTACTTGTGAATCAAG
TCCCCAGTCAATGAACGAC -> CCCCAGTCAATGAACGACT
CCCCAGTCAATGAACGACT -> CCCAGTCAATGAACGACTC
TGGACCTCTCTTACACTGA -> GGACCTCTCTTACACTGAA
GGACCTCTCTTACACTGAA -> GACCTCTCTTACACTGAAA
CACGGACCACGTTCCGATT -> ACGGACCACGTTCCGATTA
ACGGACCACGTTCCGATTA -> CGGACCACGTTCCGATTAA
ACGTCGAGTTATCCAAATC -> CGTCGAGTTATCCAAATCG
AATTCAGCTCCCTCGCCTC -> ATTCAGCTCCCTCGCCTCG
ATTCAGCTCCCTCGCCTCG -> TTCAGCTCCCTCGCCTCGG
CCAATATAGGTTTTGAAGG -> CAATATAGGTTTTGAAGGT
CAATATAGGTTTTGAAGGT -> AATATAGGTTTTGAAGGTG
CGGGATCCTGCCGTCCTCG -> GGGATCCTGCCGTCCTCGT
GGGATCCTGCCGTCCTCGT -> GGATCCTGCCGTCCTCGTC
GCAATACACGGAGCCCCTA -> CAATACACGGAGCCCCTAG
CAATACACGGAGCCCCTAG -> AATACACGGAGCCCCTAGG
GGTTACGCACATACTGAAT -> GTTACGCACATACTGAATG
GCATATAAGTGACCCTCCG -> CATATAAGTGACCCTCCGG
CATATAAGTGACCCTCCGG -> ATATAAGTGACCCTCCGGC
TCGCAATTAGTTGTGTTCC -> CGCAATTAGTTGTGTTCCG
CGCAATTAGTTGTGTTCCG -> GCAATTAGTTGTGTTCCGA
TCATCCCTGGTCCCAGGCA -> CATCCCTGGTCCCAGGCAG
CATCCCTGGTCCCAGGCAG -> ATCCCTGGTCCCAGGCAGG
GCGATTCTGGTTGAACCAC -> CGATTCTGGTTGAACCACT
CGATTCTGGTTGAACCACT -> GATTCTGGTTGAACCACTG
GTTGAATTAGCTCACAAAG -> TTGAATTAGCTCACAAAGA
TTGAATTAGCTCACAAAGA -> TGAATTAGCTCACAAAGAA
TGCTACTAGTTTGTGACTG -> GCTACTAGTTTGTGACTGA
GGTTCATCCCACGGGGGAC -> GTTCATCCCACGGGGGACA
ACACGCGATCTGCAACCCA -> CACGCGATCTGCAACCCAG
CACGCGATCTGCAACCCAG -> ACGCGATCTGCAACCCAGA
TTGTCAACTACCATAGCAA -> TGTCAACTACCATAGCAAT
TGTCAACTACCATAGCAAT -> GTCAACTACCATAGCAATA
TGAGTGCTTTCACTGTGCC -> GAGTGCTTTCACTGTGCCG
GAGTGCTTTCACTGTGCCG -> AGTGCTTTCACTGTGCCGG
CACGTGCCTAAAAACTAGC -> ACGTGCCTAAAAACTAGCA
ACGTGCCTAAAAACTAGCA -> CGTGCCTAAAAACTAGCAC
ACGCTAGCTAAGGTGACCA -> CGCTAGCTAAGGTGACCAA
CGCTAGCTAAGGTGACCAA -> GCTAGCTAAGGTGACCAAT
GTCCCCAGTCAATGAACGA -> TCCCCAGTCAATGAACGAC
GGCGCGTACAAGATAAGCC -> GCGCGTACAAGATAAGCCT
GCGCGTACAAGATAAGCCT -> CGCGTACAAGATAAGCCTA
TAGCACGGACCTAATATGC -> AGCACGGACCTAATATGCT
CTGGTCCCGCCCGATGCCC -> TGGTCCCGCCCGATGCCCT
TGGTCCCGCCCGATGCCCT -> GGTCCCGCCCGATGCCCTG
TGGCGACCTTCAATAGTAC -> GGCGACCTTCAATAGTACG
GGCGACCTTCAATAGTACG -> GCGACCTTCAATAGTACGC
GGTTTTAAAAACTAGCACG -> GTTTTAAAAACTAGCACGG
ATATGCTACAAACTATCAT -> TATGCTACAAACTATCATC
TATGCTACAAACTATCATC -> ATGCTACAAACTATCATCC
TGTGTTCCGACCTTCCGGA -> GTGTTCCGACCTTCCGGAC
GTGTTCCGACCTTCCGGAC -> TGTTCCGACCTTCCGGACT
CCTTTAGTAATTCCGGATA -> CTTTAGTAATTCCGGATAC
CGCAACCCCTAGCCTTTAA -> GCAACCCCTAGCCTTTAAT
GCAACCCCTAGCCTTTAAT -> CAACCCCTAGCCTTTAATC
TGCAAAACATTGAACTCGG -> GCAAAACATTGAACTCGGC
GCAAAACATTGAACTCGGC -> CAAAACATTGAACTCGGCA
GTTACGCACATACTGAATG -> TTACGCACATACTGAATGG
GGCTGGGGATAACTAATCA -> GCTGGGGATAACTAATCAT
GCTGGGGATAACTAATCAT -> CTGGGGATAACTAATCATT
CCCCTAGCCTTTAATCATC -> CCCTAGCCTTTAATCATCA
CCCTAGCCTTTAATCATCA -> CCTAGCCTTTAATCATCAC
TTCCTTCGCTAGCCGGTAG -> TCCTTCGCTAGCCGGTAGT
CTGGGGATAACTAATCATT -> TGGGGATAACTAATCATTT
CCGCAACCCCTAGCCTTTA -> CGCAACCCCTAGCCTTTAA
AATTAGCTCACAAAGAAAT -> ATTAGCTCACAAAGAAATC
ATTAGCTCACAAAGAAATC -> TTAGCTCACAAAGAAATCT
GTTGCGTAGGGGTATATTG -> TTGCGTAGGGGTATATTGC
TTGCGTAGGGGTATATTGC -> TGCGTAGGGGTATATTGCG
GTCCCGCACGGCGTTCCCC -> TCCCGCACGGCGTTCCCCG
GATATGCGTACTCAAACGT -> ATATGCGTACTCAAACGTC
AAGGATGCTGTTTGGCTGC -> AGGATGCTGTTTGGCTGCG
AGGATGCTGTTTGGCTGCG -> GGATGCTGTTTGGCTGCGT
GTACAAGATAAGCCTACGG -> TACAAGATAAGCCTACGGC
TACAAGATAAGCCTACGGC -> ACAAGATAAGCCTACGGCG
GAAGACTCCTATCGGGATC -> AAGACTCCTATCGGGATCC
AAGACTCCTATCGGGATCC -> AGACTCCTATCGGGATCCT
ATCTCGCATGGTCACGTTC -> TCTCGCATGGTCACGTTCG
TCTCGCATGGTCACGTTCG -> CTCGCATGGTCACGTTCGG
GGGAGGTTTCGAGCCCAAT -> GGAGGTTTCGAGCCCAATA
GGAGGTTTCGAGCCCAATA -> GAGGTTTCGAGCCCAATAA
TTACCAGCCTTGGACCAAG -> TACCAGCCTTGGACCAAGG
TACCAGCCTTGGACCAAGG -> ACCAGCCTTGGACCAAGGT
TGATCCTAGTCGTAGAGCC -> GATCCTAGTCGTAGAGCCT
GATCCTAGTCGTAGAGCCT -> ATCCTAGTCGTAGAGCCTG
CAATTGACTCAGCACCGAC -> AATTGACTCAGCACCGACT
AGCGGAGGCCTCCACGAGT -> GCGGAGGCCTCCACGAGTC
GCGGAGGCCTCCACGAGTC -> CGGAGGCCTCCACGAGTCT
TGGTTTAAAATATAACAAT -> GGTTTAAAATATAACAATA
GGTTTAAAATATAACAATA -> GTTTAAAATATAACAATAA
CGTATTCAAGCAATGCGTG -> GTATTCAAGCAATGCGTGT
GTATTCAAGCAATGCGTGT -> TATTCAAGCAATGCGTGTC
ATCCCATCTCGCATGGTCA -> TCCCATCTCGCATGGTCAC
TCCCATCTCGCATGGTCAC -> CCCATCTCGCATGGTCACG
GGTGAAGTGGCCACTTCGC -> GTGAAGTGGCCACTTCGCT
CCTCGTCTTGAAAGGTTTT -> CTCGTCTTGAAAGGTTTTG
CTCGTCTTGAAAGGTTTTG -> TCGTCTTGAAAGGTTTTGA
CGGAGCCCCTAGGCGTAGG -> GGAGCCCCTAGGCGTAGGT
GGAGCCCCTAGGCGTAGGT -> GAGCCCCTAGGCGTAGGTT
GATCCCATCTCGCATGGTC -> ATCCCATCTCGCATGGTCA
GTCCTCGTCTTGAAAGGTT -> TCCTCGTCTTGAAAGGTTT
TCCTCGTCTTGAAAGGTTT -> CCTCGTCTTGAAAGGTTTT
ACGAGTCTTGGGGAGGTTT -> CGAGTCTTGGGGAGGTTTC
CGAGTCTTGGGGAGGTTTC -> GAGTCTTGGGGAGGTTTCG
AGCTAGTGAAGTTCTACCA -> GCTAGTGAAGTTCTACCAA
GCTAGTGAAGTTCTACCAA -> CTAGTGAAGTTCTACCAAT
ACTTCGCTGTACAAAGAAC -> CTTCGCTGTACAAAGAACA
CTTCGCTGTACAAAGAACA -> TTCGCTGTACAAAGAACAA
CACTGAAAAATTGAAAGGA -> ACTGAAAAATTGAAAGGAT
ACTGAAAAATTGAAAGGAT -> CTGAAAAATTGAAAGGATG
TTCTTGTTAGCTACCCACC -> TCTTGTTAGCTACCCACCT
TCTTGTTAGCTACCCACCT -> CTTGTTAGCTACCCACCTA
CGCAGTCGGCTGGGGATAA -> GCAGTCGGCTGGGGATAAC
TTGACTAACGTGATACCAA -> TGACTAACGTGATACCAAC
TGACTAACGTGATACCAAC -> GACTAACGTGATACCAACT
CCACGAGTCTTGGGGAGGT -> CACGAGTCTTGGGGAGGTT
CACGAGTCTTGGGGAGGTT -> ACGAGTCTTGGGGAGGTTT
GTGACCCTCCGGCACTGGG -> TGACCCTCCGGCACTGGGA
TGACCCTCCGGCACTGGGA -> GACCCTCCGGCACTGGGAC
TTGATGGTTGCTACTCTAA -> TGATGGTTGCTACTCTAAC
TGATGGTTGCTACTCTAAC -> GATGGTTGCTACTCTAACT
ATTCCTCAAGCCGGGATAT -> TTCCTCAAGCCGGGATATG
TTCCTCAAGCCGGGATATG -> TCCTCAAGCCGGGATATGC
AGTTTGTGACTGAACTTTT -> GTTTGTGACTGAACTTTTG
ACCCCAAGCTACTTAAACT -> CCCCAAGCTACTTAAACTA
CCCCAAGCTACTTAAACTA -> CCCAAGCTACTTAAACTAT
TCCCGCACGGCGTTCCCCG -> CCCGCACGGCGTTCCCCGA
CCCGCACGGCGTTCCCCGA -> CCGCACGGCGTTCCCCGAG
GGCGGGGGGTTGATGGGGG -> GCGGGGGGTTGATGGGGGT
GCGGGGGGTTGATGGGGGT -> CGGGGGGTTGATGGGGGTG
GAACATACGACAGCGGAGG -> AACATACGACAGCGGAGGC
TGAGAAAAGCAGAATACAG -> GAGAAAAGCAGAATACAGA
GAGAAAAGCAGAATACAGA -> AGAAAAGCAGAATACAGAT
TGAATTAGCTCACAAAGAA -> GAATTAGCTCACAAAGAAA
AGATCTCCAGGCACACACG -> GATCTCCAGGCACACACGC
GATCTCCAGGCACACACGC -> ATCTCCAGGCACACACGCG
TAGTAATTCCGGATACTGA -> AGTAATTCCGGATACTGAC
AGTAATTCCGGATACTGAC -> GTAATTCCGGATACTGACG
CTTACAAATTAATATGCAC -> TTACAAATTAATATGCACT
TTACAAATTAATATGCACT -> TACAAATTAATATGCACTT
TTACTAGAGCAACGCACCC -> TACTAGAGCAACGCACCCA
TACTAGAGCAACGCACCCA -> ACTAGAGCAACGCACCCAC
TCGTCTTGAAAGGTTTTGA -> CGTCTTGAAAGGTTTTGAG
CGTCTTGAAAGGTTTTGAG -> GTCTTGAAAGGTTTTGAGA
ATTGCGACCTTCTACTCAG -> TTGCGACCTTCTACTCAGA
TTGCGACCTTCTACTCAGA -> TGCGACCTTCTACTCAGAT
GCTTATACATCTGTTACCG -> CTTATACATCTGTTACCGT
TAAGGTGACCAATATAGGT -> AAGGTGACCAATATAGGTT
AAGGTGACCAATATAGGTT -> AGGTGACCAATATAGGTTT
TTGGCTGCGTTGTATTCCT -> TGGCTGCGTTGTATTCCTC
TGGCTGCGTTGTATTCCTC -> GGCTGCGTTGTATTCCTCA
GCCTGTTGCAAAACATTGA -> CCTGTTGCAAAACATTGAA
CCTGTTGCAAAACATTGAA -> CTGTTGCAAAACATTGAAC
CTGATAAATAATCGATTGG -> TGATAAATAATCGATTGGG
TGATAAATAATCGATTGGG -> GATAAATAATCGATTGGGG
AGTGACCTTGGAATGGTAT -> GTGACCTTGGAATGGTATG
GTGACCTTGGAATGGTATG -> TGACCTTGGAATGGTATGG
ATGAACGACTCGGATAAAA -> TGAACGACTCGGATAAAAT
TGAACGACTCGGATAAAAT -> GAACGACTCGGATAAAATA
TCCAAATCGCCCTCGCAGT -> CCAAATCGCCCTCGCAGTC
CCAAATCGCCCTCGCAGTC -> CAAATCGCCCTCGCAGTCG
AGGTGAGAACATACGACAG -> GGTGAGAACATACGACAGC
GGTGAGAACATACGACAGC -> GTGAGAACATACGACAGCG
AAAAACTAGCACGGACCGT -> AAAACTAGCACGGACCGTG
AAAACTAGCACGGACCGTG -> AAACTAGCACGGACCGTGG
GTGGCCACTTCGCTGTACA -> TGGCCACTTCGCTGTACAA
TGGCCACTTCGCTGTACAA -> GGCCACTTCGCTGTACAAA
GACAGCGGAGGCCTCCACG -> ACAGCGGAGGCCTCCACGA
ACAGCGGAGGCCTCCACGA -> CAGCGGAGGCCTCCACGAG
GGCACCACGGTAGTCGAAC -> GCACCACGGTAGTCGAACA
GCACCACGGTAGTCGAACA -> CACCACGGTAGTCGAACAC
GCCGTCCTCGTCTTGAAAG -> CCGTCCTCGTCTTGAAAGG
CCGTCCTCGTCTTGAAAGG -> CGTCCTCGTCTTGAAAGGT
GGTCAACGACAAGTTACTT -> GTCAACGACAAGTTACTTG
GTCAACGACAAGTTACTTG -> TCAACGACAAGTTACTTGT
GTACTCAAACGTCGAGTTA -> TACTCAAACGTCGAGTTAT
CGATTTATATAATGCACAT -> GATTTATATAATGCACATC
GATTTATATAATGCACATC -> ATTTATATAATGCACATCC
TGAAGACTCCTATCGGGAT -> GAAGACTCCTATCGGGATC
CGGCGGCATAGACCGTAAA -> GGCGGCATAGACCGTAAAA
GGCGGCATAGACCGTAAAA -> GCGGCATAGACCGTAAAAA
CTGCCTTCGTAGGGTATAG -> TGCCTTCGTAGGGTATAGT
TGCCTTCGTAGGGTATAGT -> GCCTTCGTAGGGTATAGTA
TCACGTTCGGTCAACGACA -> CACGTTCGGTCAACGACAA
CAAAACATTGAACTCGGCA -> AAAACATTGAACTCGGCAC
AGGAGCCAGGAACTTAACT -> GGAGCCAGGAACTTAACTA
GGAGCCAGGAACTTAACTA -> GAGCCAGGAACTTAACTAA
GATACGCCTGTTGCAAAAC -> ATACGCCTGTTGCAAAACA
ATACGCCTGTTGCAAAACA -> TACGCCTGTTGCAAAACAT
CTGCGCGAGTAGTTGTCTC -> TGCGCGAGTAGTTGTCTCC
TGCGCGAGTAGTTGTCTCC -> GCGCGAGTAGTTGTCTCCT
TCCCTGGTCCGAGTGCAAC -> CCCTGGTCCGAGTGCAACT
CCCTGGTCCGAGTGCAACT -> CCTGGTCCGAGTGCAACTT
TGGCACGACTCACATTTCT -> GGCACGACTCACATTTCTT
GGCACGACTCACATTTCTT -> GCACGACTCACATTTCTTG
TGCGAAAAATGGTGGACCT -> GCGAAAAATGGTGGACCTC
TCTGAGCATATAAGTGACC -> CTGAGCATATAAGTGACCC
CTGAGCATATAAGTGACCC -> TGAGCATATAAGTGACCCT
ATACCAACTAGCGATTCTG -> TACCAACTAGCGATTCTGG
TACCAACTAGCGATTCTGG -> ACCAACTAGCGATTCTGGT
TAATATGCACTTGCGAAGT -> AATATGCACTTGCGAAGTA
AATATGCACTTGCGAAGTA -> ATATGCACTTGCGAAGTAA
ACAAAGTTTGCAGCTTATA -> CAAAGTTTGCAGCTTATAC
CAAAGTTTGCAGCTTATAC -> AAAGTTTGCAGCTTATACA
GTGTATTTGAAGACTCCTA -> TGTATTTGAAGACTCCTAT
TGTATTTGAAGACTCCTAT -> GTATTTGAAGACTCCTATC
GACACACCCAATTGACTCA -> ACACACCCAATTGACTCAG
ACACACCCAATTGACTCAG -> CACACCCAATTGACTCAGC
GGTTGATGGGGGTGCTGCT -> GTTGATGGGGGTGCTGCTC
GTTGATGGGGGTGCTGCTC -> TTGATGGGGGTGCTGCTCC
AGTGCTTTCACTGTGCCGG -> GTGCTTTCACTGTGCCGGT
CGCCTCGGTCGGGGAGTCC -> GCCTCGGTCGGGGAGTCCC
TCAACGACAAGTTACTTGT -> CAACGACAAGTTACTTGTG
CAACGACAAGTTACTTGTG -> AACGACAAGTTACTTGTGA
TAATCATTTTACTAGAGCA -> AATCATTTTACTAGAGCAA
AATCATTTTACTAGAGCAA -> ATCATTTTACTAGAGCAAC
AACGACTCGGATAAAATAA -> ACGACTCGGATAAAATAAC
ACGACTCGGATAAAATAAC -> CGACTCGGATAAAATAACG
ATCATTTTACTAGAGCAAC -> TCATTTTACTAGAGCAACG
TCATTTTACTAGAGCAACG -> CATTTTACTAGAGCAACGC
CGGGATATGCGTACTCAAA -> GGGATATGCGTACTCAAAC
CCTGAGCGCTTGAGAAGTT -> CTGAGCGCTTGAGAAGTTA
CTGAGCGCTTGAGAAGTTA -> TGAGCGCTTGAGAAGTTAG
TTGAAAGGATGCTGTTTGG -> TGAAAGGATGCTGTTTGGC
TGAAAGGATGCTGTTTGGC -> GAAAGGATGCTGTTTGGCT
CTCCTCTTCAAGGCGAGTG -> TCCTCTTCAAGGCGAGTGA
TCCTCTTCAAGGCGAGTGA -> CCTCTTCAAGGCGAGTGAC
AGAAGTTAGCGGCGGCATA -> GAAGTTAGCGGCGGCATAG
GAAGTTAGCGGCGGCATAG -> AAGTTAGCGGCGGCATAGA
CTGCAACCCAGATATACAC -> TGCAACCCAGATATACACT
TGCAACCCAGATATACACT -> GCAACCCAGATATACACTT
AACTAGCACGGACCTAATA -> ACTAGCACGGACCTAATAT
ACTAGCACGGACCTAATAT -> CTAGCACGGACCTAATATG
AATAAAAACTAGCACGGAC -> ATAAAAACTAGCACGGACC
ATAAAAACTAGCACGGACC -> TAAAAACTAGCACGGACCA
AAAAGCAGAATACAGATAA -> AAAGCAGAATACAGATAAC
AAAGCAGAATACAGATAAC -> AAGCAGAATACAGATAACC
CACCCCTAAAACGACACGC -> ACCCCTAAAACGACACGCG
GCTTGTCAAACTATCATCC -> CTTGTCAAACTATCATCCC
ACGCTAGCTTGCCATGTCG -> CGCTAGCTTGCCATGTCGA
CGCTAGCTTGCCATGTCGA -> GCTAGCTTGCCATGTCGAT
ACTACCATAGCAATACACG -> CTACCATAGCAATACACGG
GGTCCCAGGCAGGCAACAT -> GTCCCAGGCAGGCAACATT
GGACCACGTTCCGATTAAA -> GACCACGTTCCGATTAAAC
GACCACGTTCCGATTAAAC -> ACCACGTTCCGATTAAACT
TAATTCTGAGCATATAAGT -> AATTCTGAGCATATAAGTG
AATTCTGAGCATATAAGTG -> ATTCTGAGCATATAAGTGA
CTCGTATTCAAGCAATGCG -> TCGTATTCAAGCAATGCGT
TCGTATTCAAGCAATGCGT -> CGTATTCAAGCAATGCGTG
AAGGTTTTGAGAAGTTGGG -> AGGTTTTGAGAAGTTGGGA
AGGTTTTGAGAAGTTGGGA -> GGTTTTGAGAAGTTGGGAA
CGGGGGGTTGATGGGGGTG -> GGGGGGTTGATGGGGGTGC
TGCCTTATGCTTCGACGCT -> GCCTTATGCTTCGACGCTA
GCCTTATGCTTCGACGCTA -> CCTTATGCTTCGACGCTAG
CGTACAAGATAAGCCTACG -> GTACAAGATAAGCCTACGG
TAGGCGTAGGTTCATCCCA -> AGGCGTAGGTTCATCCCAC
GACCTCTCTTACACTGAAA -> ACCTCTCTTACACTGAAAA
CATTTTACTAGAGCAACGC -> ATTTTACTAGAGCAACGCA
CCTGGTTTAAAATATAACA -> CTGGTTTAAAATATAACAA
CTGGTTTAAAATATAACAA -> TGGTTTAAAATATAACAAT
ACGGACCGTGGGCTTGTCA -> CGGACCGTGGGCTTGTCAA
CGGACCGTGGGCTTGTCAA -> GGACCGTGGGCTTGTCAAA
ATACTCCGAGTCCGCAGGG -> TACTCCGAGTCCGCAGGGA
TACTCCGAGTCCGCAGGGA -> ACTCCGAGTCCGCAGGGAC
TATCCAAATCGCCCTCGCA -> ATCCAAATCGCCCTCGCAG
GCCTTCGTAGGGTATAGTA -> CCTTCGTAGGGTATAGTAA
CCTTCGTAGGGTATAGTAA -> CTTCGTAGGGTATAGTAAT
TAATGGTGTATTTGAAGAC -> AATGGTGTATTTGAAGACT
AATGGTGTATTTGAAGACT -> ATGGTGTATTTGAAGACTC
CTCTGATAAATAATCGATT -> TCTGATAAATAATCGATTG
TCTGATAAATAATCGATTG -> CTGATAAATAATCGATTGG
GTTAGCTACCCACCTACCG -> TTAGCTACCCACCTACCGA
TAGCGATTCTGGTTGAACC -> AGCGATTCTGGTTGAACCA
AGCGATTCTGGTTGAACCA -> GCGATTCTGGTTGAACCAC
AAATCTCGTCCTGCCTTCG -> AATCTCGTCCTGCCTTCGT
GACACGCGCTTACAAATTA -> ACACGCGCTTACAAATTAA
ACACGCGCTTACAAATTAA -> CACGCGCTTACAAATTAAT
ACTGAACTTTTGATGGTTG -> CTGAACTTTTGATGGTTGC
CTGAACTTTTGATGGTTGC -> TGAACTTTTGATGGTTGCT
TCTCCTGGTTTAAAATATA -> CTCCTGGTTTAAAATATAA
AATATAACAATAAACCGTA -> ATATAACAATAAACCGTAC
ATATAACAATAAACCGTAC -> TATAACAATAAACCGTACC
CAACCCCTAGCCTTTAATC -> AACCCCTAGCCTTTAATCA
AACCCCTAGCCTTTAATCA -> ACCCCTAGCCTTTAATCAT
GCTTGTCAACTACCATAGC -> CTTGTCAACTACCATAGCA
CTTGTCAACTACCATAGCA -> TTGTCAACTACCATAGCAA
ACGCACATACTGAATGGAC -> CGCACATACTGAATGGACG
CGCACATACTGAATGGACG -> GCACATACTGAATGGACGC
TCAGCACCGACTGTCTGCT -> CAGCACCGACTGTCTGCTC
CAGCACCGACTGTCTGCTC -> AGCACCGACTGTCTGCTCT
CCCATCTCGCATGGTCACG -> CCATCTCGCATGGTCACGT
CCATCTCGCATGGTCACGT -> CATCTCGCATGGTCACGTT
CTTAAGACATGACCAGTAT -> TTAAGACATGACCAGTATA
CACTTGCTGGGTTAAGTTC -> ACTTGCTGGGTTAAGTTCT
ACTTGCTGGGTTAAGTTCT -> CTTGCTGGGTTAAGTTCTA
CTCGGCACCACGGTAGTCG -> TCGGCACCACGGTAGTCGA
TCGGCACCACGGTAGTCGA -> CGGCACCACGGTAGTCGAA
CCCACCTACCGAACGCTTG -> CCACCTACCGAACGCTTGG
TGAACTTTTGATGGTTGCT -> GAACTTTTGATGGTTGCTA
GCTACTCTAACTAGCAGGC -> CTACTCTAACTAGCAGGCA
CTACTCTAACTAGCAGGCA -> TACTCTAACTAGCAGGCAG
GTCTTGAAAGGTTTTGAGA -> TCTTGAAAGGTTTTGAGAA
CCGTACCATATTAGCCCTC -> CGTACCATATTAGCCCTCG
GCCCCGCAACCCCTAGCCT -> CCCCGCAACCCCTAGCCTT
GAATTAGCTCACAAAGAAA -> AATTAGCTCACAAAGAAAT
GGTGACCAATATAGGTTTT -> GTGACCAATATAGGTTTTG
GTGACCAATATAGGTTTTG -> TGACCAATATAGGTTTTGA
AACTATCATCCCTGGTCCG -> ACTATCATCCCTGGTCCGA
GGCGCCACCCAGCCATGGC -> GCGCCACCCAGCCATGGCG
CGTAGGGGTATATTGCGAC -> GTAGGGGTATATTGCGACC
GTAGGGGTATATTGCGACC -> TAGGGGTATATTGCGACCT
CTCTCTTACACTGAAAAAT -> TCTCTTACACTGAAAAATT
TCTCTTACACTGAAAAATT -> CTCTTACACTGAAAAATTG
TCAACGATACGCCTGTTGC -> CAACGATACGCCTGTTGCA
CAACGATACGCCTGTTGCA -> AACGATACGCCTGTTGCAA
ACGACAAGTTACTTGTGAA -> CGACAAGTTACTTGTGAAT
ACCTCCTCGTATTCAAGCA -> CCTCCTCGTATTCAAGCAA
CCTCCTCGTATTCAAGCAA -> CTCCTCGTATTCAAGCAAT
GCAGAATACAGATAACCCG -> CAGAATACAGATAACCCGC
CAGAATACAGATAACCCGC -> AGAATACAGATAACCCGCT
CCCTGGTCCCGCCCGATGC -> CCTGGTCCCGCCCGATGCC
CCTGGTCCCGCCCGATGCC -> CTGGTCCCGCCCGATGCCC
TCATGCTACTAGTTTGTGA -> CATGCTACTAGTTTGTGAC
TCTCTCATGGCGCGTACAA -> CTCTCATGGCGCGTACAAG
CTCTCATGGCGCGTACAAG -> TCTCATGGCGCGTACAAGA
TAGTTGTCTCCTCTTCTCT -> AGTTGTCTCCTCTTCTCTG
AGTTGTCTCCTCTTCTCTG -> GTTGTCTCCTCTTCTCTGA
ACGACAGCGGAGGCCTCCA -> CGACAGCGGAGGCCTCCAC
CGACAGCGGAGGCCTCCAC -> GACAGCGGAGGCCTCCACG
AAGTTACTTGTGAATCAAG -> AGTTACTTGTGAATCAAGC
AGTTACTTGTGAATCAAGC -> GTTACTTGTGAATCAAGCA
CCACGGGGGACAAGCCTGA -> CACGGGGGACAAGCCTGAG
CACGGGGGACAAGCCTGAG -> ACGGGGGACAAGCCTGAGT
CAAGCAATGCGTGTCCCAC -> AAGCAATGCGTGTCCCACC
AAGCAATGCGTGTCCCACC -> AGCAATGCGTGTCCCACCT
CTGAATGGACGCTAGCTTG -> TGAATGGACGCTAGCTTGC
TGAATGGACGCTAGCTTGC -> GAATGGACGCTAGCTTGCC
GCGTACAAGATAAGCCTAC -> CGTACAAGATAAGCCTACG
GTCCCGTAAAGCACGTGCC -> TCCCGTAAAGCACGTGCCT
GAGCCCCTAGGCGTAGGTT -> AGCCCCTAGGCGTAGGTTC
GACCTTCGAGAACTCCGCG -> ACCTTCGAGAACTCCGCGA
ACCTTCGAGAACTCCGCGA -> CCTTCGAGAACTCCGCGAC
CCGTGCAGCTAGTGAAGTT -> CGTGCAGCTAGTGAAGTTC
CGTGCAGCTAGTGAAGTTC -> GTGCAGCTAGTGAAGTTCT
AGCCGGTAGTTAAGGTGAG -> GCCGGTAGTTAAGGTGAGA
CACATTTCTTGTTAGCTAC -> ACATTTCTTGTTAGCTACC
ACATTTCTTGTTAGCTACC -> CATTTCTTGTTAGCTACCC
TTTAATCATCACCCCTAAA -> TTAATCATCACCCCTAAAA
ATCTCTAGCTGATCCCATC -> TCTCTAGCTGATCCCATCT
TCTCTAGCTGATCCCATCT -> CTCTAGCTGATCCCATCTC
GGTCCCGCCCGATGCCCTG -> GTCCCGCCCGATGCCCTGA
GTCCCGCCCGATGCCCTGA -> TCCCGCCCGATGCCCTGAC
CACTGCCTTATGCTTCGAC -> ACTGCCTTATGCTTCGACG
ACTGCCTTATGCTTCGACG -> CTGCCTTATGCTTCGACGC
TTTAAAAACTAGCACGGAC -> TTAAAAACTAGCACGGACC
TTAAAAACTAGCACGGACC -> TAAAAACTAGCACGGACCT
CCGTAAAGCACGTGCCTAA -> CGTAAAGCACGTGCCTAAA
CGTAAAGCACGTGCCTAAA -> GTAAAGCACGTGCCTAAAA
TAATTCCGGATACTGACGG -> AATTCCGGATACTGACGGG
AATTCCGGATACTGACGGG -> ATTCCGGATACTGACGGGA
TTCGGTCAACGACAAGTTA -> TCGGTCAACGACAAGTTAC
TCGGTCAACGACAAGTTAC -> CGGTCAACGACAAGTTACT
TGCCCTGACTCGCCCGTAC -> GCCCTGACTCGCCCGTACG
GCCCTGACTCGCCCGTACG -> CCCTGACTCGCCCGTACGC
TACTCCTCTTCAAGGCGAG -> ACTCCTCTTCAAGGCGAGT
ACTCCTCTTCAAGGCGAGT -> CTCCTCTTCAAGGCGAGTG
CCGTAAGCTCTCCTGGTTT -> CGTAAGCTCTCCTGGTTTA
CGTAAGCTCTCCTGGTTTA -> GTAAGCTCTCCTGGTTTAA
CCTTATGCTTCGACGCTAG -> CTTATGCTTCGACGCTAGC
CTTATGCTTCGACGCTAGC -> TTATGCTTCGACGCTAGCT
TGTCTCCTCTTCTCTGATA -> GTCTCCTCTTCTCTGATAA
GTCTCCTCTTCTCTGATAA -> TCTCCTCTTCTCTGATAAA
CGTCCTCGTCTTGAAAGGT -> GTCCTCGTCTTGAAAGGTT
CGGTAGTCGAACACTCGCA -> GGTAGTCGAACACTCGCAA
GGTAGTCGAACACTCGCAA -> GTAGTCGAACACTCGCAAT
GTTTTGAAGGTGAAGTGGC -> TTTTGAAGGTGAAGTGGCC
GTTCCGACCTTCCGGACTG -> TTCCGACCTTCCGGACTGC
TTCCGACCTTCCGGACTGC -> TCCGACCTTCCGGACTGCG
TGTATTCCTCAAGCCGGGA -> GTATTCCTCAAGCCGGGAT
GTATTCCTCAAGCCGGGAT -> TATTCCTCAAGCCGGGATA
ATGGACGCTAGCTTGCCAT -> TGGACGCTAGCTTGCCATG
TGGACGCTAGCTTGCCATG -> GGACGCTAGCTTGCCATGT
CACACCCAATTGACTCAGC -> ACACCCAATTGACTCAGCA
ACACCCAATTGACTCAGCA -> CACCCAATTGACTCAGCAC
CGCGACGCCCCGCAACCCC -> GCGACGCCCCGCAACCCCT
GCGACGCCCCGCAACCCCT -> CGACGCCCCGCAACCCCTA
TTGAAGGTGAAGTGGCCAC -> TGAAGGTGAAGTGGCCACT
TGAAGGTGAAGTGGCCACT -> GAAGGTGAAGTGGCCACTT
TATAATTCAGCTCCCTCGC -> ATAATTCAGCTCCCTCGCC
ATAATTCAGCTCCCTCGCC -> TAATTCAGCTCCCTCGCCT
GGAGGCCTCCACGAGTCTT -> GAGGCCTCCACGAGTCTTG
GAGGCCTCCACGAGTCTTG -> AGGCCTCCACGAGTCTTGG
CTTGCTGGGTTAAGTTCTA -> TTGCTGGGTTAAGTTCTAC
TTGCTGGGTTAAGTTCTAC -> TGCTGGGTTAAGTTCTACT
CATGTCGATTTATATAATG -> ATGTCGATTTATATAATGC
ATGTCGATTTATATAATGC -> TGTCGATTTATATAATGCA
GACGCCCCGCAACCCCTAG -> ACGCCCCGCAACCCCTAGC
ACGCCCCGCAACCCCTAGC -> CGCCCCGCAACCCCTAGCC
CGCCCGTACGCCTTCCGTG -> GCCCGTACGCCTTCCGTGC
TCCCGCCCGATGCCCTGAC -> CCCGCCCGATGCCCTGACT
CCCGCCCGATGCCCTGACT -> CCGCCCGATGCCCTGACTC
ATCTGCAACCCAGATATAC -> TCTGCAACCCAGATATACA
TCTGCAACCCAGATATACA -> CTGCAACCCAGATATACAC
GTCGGGGAGTCCCCAGTCA -> TCGGGGAGTCCCCAGTCAA
TCGGGGAGTCCCCAGTCAA -> CGGGGAGTCCCCAGTCAAT
TAACTAATGGTGTATTTGA -> AACTAATGGTGTATTTGAA
CATCTCGCATGGTCACGTT -> ATCTCGCATGGTCACGTTC
ATAACGATGTTGAATTAGC -> TAACGATGTTGAATTAGCT
TAACGATGTTGAATTAGCT -> AACGATGTTGAATTAGCTC
GTCCCAGGCAGGCAACATT -> TCCCAGGCAGGCAACATTT
TCCCAGGCAGGCAACATTT -> CCCAGGCAGGCAACATTTA
TTGACTCAGCACCGACTGT -> TGACTCAGCACCGACTGTC
GTAGTTAAGGTGAGAACAT -> TAGTTAAGGTGAGAACATA
TAGTTAAGGTGAGAACATA -> AGTTAAGGTGAGAACATAC
GCCACCCAGCCATGGCGAC -> CCACCCAGCCATGGCGACC
TCTCATGGCGCGTACAAGA -> CTCATGGCGCGTACAAGAT
CTCCGAGTCCGCAGGGACC -> TCCGAGTCCGCAGGGACCT
TCCGAGTCCGCAGGGACCT -> CCGAGTCCGCAGGGACCTT
GAAAAGCAGAATACAGATA -> AAAAGCAGAATACAGATAA
TAGCACGGACCACGTTCCG -> AGCACGGACCACGTTCCGA
AGCACGGACCACGTTCCGA -> GCACGGACCACGTTCCGAT
TTAATATGCACTTGCGAAG -> TAATATGCACTTGCGAAGT
CCACCCAGCCATGGCGACC -> CACCCAGCCATGGCGACCT
CACCCAGCCATGGCGACCT -> ACCCAGCCATGGCGACCTT
CCGCCCGATGCCCTGACTC -> CGCCCGATGCCCTGACTCG
CACGTTCCGATTAAACTAT -> ACGTTCCGATTAAACTATC
ACGTTCCGATTAAACTATC -> CGTTCCGATTAAACTATCA
AAACTAGCACGGACCGTGG -> AACTAGCACGGACCGTGGG
AACTAGCACGGACCGTGGG -> ACTAGCACGGACCGTGGGC
ATTTCTAGCGGTGCGAAAA -> TTTCTAGCGGTGCGAAAAA
TTTCTAGCGGTGCGAAAAA -> TTCTAGCGGTGCGAAAAAT
ACCCCTAAAACGACACGCG -> CCCCTAAAACGACACGCGC
TACTGATCCTAGTCGTAGA -> ACTGATCCTAGTCGTAGAG
ACTGATCCTAGTCGTAGAG -> CTGATCCTAGTCGTAGAGC
CAGCCATGGCGACCTTCAA -> AGCCATGGCGACCTTCAAT
GTGTTCCTTCGCTAGCCGG -> TGTTCCTTCGCTAGCCGGT
TGAGCATATAAGTGACCCT -> GAGCATATAAGTGACCCTC
GCTACTTAAACTATCATCC -> CTACTTAAACTATCATCCC
ATACTGACGGGATGGCAGC -> TACTGACGGGATGGCAGCG
TAGGGTATAGTAATTCTGA -> AGGGTATAGTAATTCTGAG
AGGGTATAGTAATTCTGAG -> GGGTATAGTAATTCTGAGC
CCTTCAATAGTACGCCTTT -> CTTCAATAGTACGCCTTTA
GGACGCTAGCTTGCCATGT -> GACGCTAGCTTGCCATGTC
GACGCTAGCTTGCCATGTC -> ACGCTAGCTTGCCATGTCG
CACCTGGTACTCGCGAGCA -> ACCTGGTACTCGCGAGCAT
ACCTGGTACTCGCGAGCAT -> CCTGGTACTCGCGAGCATC
CCTTGGACCAAGGTCGGAG -> CTTGGACCAAGGTCGGAGC
CTTGGACCAAGGTCGGAGC -> TTGGACCAAGGTCGGAGCG
GTCGGCTGGGGATAACTAA -> TCGGCTGGGGATAACTAAT
TCGGCTGGGGATAACTAAT -> CGGCTGGGGATAACTAATC
GACTCGCCCGTACGCCTTC -> ACTCGCCCGTACGCCTTCC
ACTCGCCCGTACGCCTTCC -> CTCGCCCGTACGCCTTCCG
GGACCTAATATGCTACAAA -> GACCTAATATGCTACAAAC
AGGGGATACCTGCGCAAAC -> GGGGATACCTGCGCAAACA
GGGGATACCTGCGCAAACA -> GGGATACCTGCGCAAACAA
ACGACTCACATTTCTTGTT -> CGACTCACATTTCTTGTTA
CGACTCACATTTCTTGTTA -> GACTCACATTTCTTGTTAG
GGGATACCTGCGCAAACAA -> GGATACCTGCGCAAACAAA
GGATACCTGCGCAAACAAA -> GATACCTGCGCAAACAAAG
GTTACTTGTGAATCAAGCA -> TTACTTGTGAATCAAGCAG
CGCAAACAAAGTTTGCAGC -> GCAAACAAAGTTTGCAGCT
GCAAACAAAGTTTGCAGCT -> CAAACAAAGTTTGCAGCTT
GTTTCCGAGGAGCCAGGAA -> TTTCCGAGGAGCCAGGAAC
TTTCCGAGGAGCCAGGAAC -> TTCCGAGGAGCCAGGAACT
GATACCTGCGCAAACAAAG -> ATACCTGCGCAAACAAAGT
TGTCGATTTATATAATGCA -> GTCGATTTATATAATGCAC
TCATACTGATCCTAGTCGT -> CATACTGATCCTAGTCGTA
TTCGAGAACTCCGCGACGC -> TCGAGAACTCCGCGACGCC
TCGAGAACTCCGCGACGCC -> CGAGAACTCCGCGACGCCC
ATTCTGAGCATATAAGTGA -> TTCTGAGCATATAAGTGAC
TTCTGAGCATATAAGTGAC -> TCTGAGCATATAAGTGACC
GCTTCGACGCTAGCTAAGG -> CTTCGACGCTAGCTAAGGT
CTTCGACGCTAGCTAAGGT -> TTCGACGCTAGCTAAGGTG
CCAAGGTCGGAGCGGATTG -> CAAGGTCGGAGCGGATTGC
CAAGGTCGGAGCGGATTGC -> AAGGTCGGAGCGGATTGCC
TCAAGCCGGGATATGCGTA -> CAAGCCGGGATATGCGTAC
CAAGCCGGGATATGCGTAC -> AAGCCGGGATATGCGTACT
TGGAATGGTATGGTTTTAA -> GGAATGGTATGGTTTTAAA
GGAATGGTATGGTTTTAAA -> GAATGGTATGGTTTTAAAA
ACCCAGCCATGGCGACCTT -> CCCAGCCATGGCGACCTTC
GTTGTGTTCCGACCTTCCG -> TTGTGTTCCGACCTTCCGG
TTGTGTTCCGACCTTCCGG -> TGTGTTCCGACCTTCCGGA
TTCAGCTCCCTCGCCTCGG -> TCAGCTCCCTCGCCTCGGT
TGAAAAATTGAAAGGATGC -> GAAAAATTGAAAGGATGCT
GAAAAATTGAAAGGATGCT -> AAAAATTGAAAGGATGCTG
GTTGCAAAACATTGAACTC -> TTGCAAAACATTGAACTCG
TTGCAAAACATTGAACTCG -> TGCAAAACATTGAACTCGG
CGGACCACGTTCCGATTAA -> GGACCACGTTCCGATTAAA
AGATGTTTGACTAACGTGA -> GATGTTTGACTAACGTGAT
GATGTTTGACTAACGTGAT -> ATGTTTGACTAACGTGATA
GGGGGTGCTGCTCCGCGAT -> GGGGTGCTGCTCCGCGATC
AGTAGTTGTCTCCTCTTCT -> GTAGTTGTCTCCTCTTCTC
GTAGTTGTCTCCTCTTCTC -> TAGTTGTCTCCTCTTCTCT
GAAGGTGAAGTGGCCACTT -> AAGGTGAAGTGGCCACTTC
TCCGGACTGCGCGAGTAGT -> CCGGACTGCGCGAGTAGTT
CCGGACTGCGCGAGTAGTT -> CGGACTGCGCGAGTAGTTG
GTCAATGAACGACTCGGAT -> TCAATGAACGACTCGGATA
TCAATGAACGACTCGGATA -> CAATGAACGACTCGGATAA
CTTAAACTATCATCCCTGG -> TTAAACTATCATCCCTGGT
CTGAAAAATTGAAAGGATG -> TGAAAAATTGAAAGGATGC
TCAACTACCATAGCAATAC -> CAACTACCATAGCAATACA
CAACTACCATAGCAATACA -> AACTACCATAGCAATACAC
ATCCTAGTCGTAGAGCCTG -> TCCTAGTCGTAGAGCCTGT
TCCTAGTCGTAGAGCCTGT -> CCTAGTCGTAGAGCCTGTT
TAATCGATTGGGGAGTCTC -> AATCGATTGGGGAGTCTCT
CACCCACGAAATGAGAAAA -> ACCCACGAAATGAGAAAAG
GCTGTTTGGCTGCGTTGTA -> CTGTTTGGCTGCGTTGTAT
GAGAATTTCTAGCGGTGCG -> AGAATTTCTAGCGGTGCGA
AGAATTTCTAGCGGTGCGA -> GAATTTCTAGCGGTGCGAA
TACAAATTAATATGCACTT -> ACAAATTAATATGCACTTG
GGGAGTCTCTCATGGCGCG -> GGAGTCTCTCATGGCGCGT
ATATCTCTAGCTGATCCCA -> TATCTCTAGCTGATCCCAT
TATCTCTAGCTGATCCCAT -> ATCTCTAGCTGATCCCATC
TGCGCAAACAAAGTTTGCA -> GCGCAAACAAAGTTTGCAG
GCGCAAACAAAGTTTGCAG -> CGCAAACAAAGTTTGCAGC
AATCATCACCCCTAAAACG -> ATCATCACCCCTAAAACGA
CTGAGTGCTTTCACTGTGC -> TGAGTGCTTTCACTGTGCC
ACCAAGGTCGGAGCGGATT -> CCAAGGTCGGAGCGGATTG
CATCACCCCTAAAACGACA -> ATCACCCCTAAAACGACAC
TGTTTGGCTGCGTTGTATT -> GTTTGGCTGCGTTGTATTC
GTTTGGCTGCGTTGTATTC -> TTTGGCTGCGTTGTATTCC
ATGCGTACTCAAACGTCGA -> TGCGTACTCAAACGTCGAG
TGCGTACTCAAACGTCGAG -> GCGTACTCAAACGTCGAGT
AAATTGAAAGGATGCTGTT -> AATTGAAAGGATGCTGTTT
AATTGAAAGGATGCTGTTT -> ATTGAAAGGATGCTGTTTG
CAAAGAAATCTCGTCCTGC -> AAAGAAATCTCGTCCTGCC
TATAGGTTTTGAAGGTGAA -> ATAGGTTTTGAAGGTGAAG
ACTAGCACGGACCACGTTC -> CTAGCACGGACCACGTTCC
CTAGCACGGACCACGTTCC -> TAGCACGGACCACGTTCCG
GGGCTGGAGAATTTCTAGC -> GGCTGGAGAATTTCTAGCG
GGCTGGAGAATTTCTAGCG -> GCTGGAGAATTTCTAGCGG
AGCCGGGATATGCGTACTC -> GCCGGGATATGCGTACTCA
GCCGGGATATGCGTACTCA -> CCGGGATATGCGTACTCAA
ACCCACCTACCGAACGCTT -> CCCACCTACCGAACGCTTG
CTTCCGTGCAGCTAGTGAA -> TTCCGTGCAGCTAGTGAAG
TTCCGTGCAGCTAGTGAAG -> TCCGTGCAGCTAGTGAAGT
GGGACCTTCGAGAACTCCG -> GGACCTTCGAGAACTCCGC
GGACCTTCGAGAACTCCGC -> GACCTTCGAGAACTCCGCG
TTGAAAGGTTTTGAGAAGT -> TGAAAGGTTTTGAGAAGTT
TGTTTGACTAACGTGATAC -> GTTTGACTAACGTGATACC
GTTTGACTAACGTGATACC -> TTTGACTAACGTGATACCA
ACCTAATATGCTACAAACT -> CCTAATATGCTACAAACTA
CGTAAAAACTAGCACGGAC -> GTAAAAACTAGCACGGACC
GTAAAAACTAGCACGGACC -> TAAAAACTAGCACGGACCG
CCTAAAACGACACGCGCTT -> CTAAAACGACACGCGCTTA
CTAAAACGACACGCGCTTA -> TAAAACGACACGCGCTTAC
CCACGAAATGAGAAAAGCA -> CACGAAATGAGAAAAGCAG
CACGAAATGAGAAAAGCAG -> ACGAAATGAGAAAAGCAGA
ATCATCCCTGGTCCCGTAA -> TCATCCCTGGTCCCGTAAA
TCATCCCTGGTCCCGTAAA -> CATCCCTGGTCCCGTAAAG
CACACACGCGATCTGCAAC -> ACACACGCGATCTGCAACC
ACACACGCGATCTGCAACC -> CACACGCGATCTGCAACCC
TTGAGAAGTTAGCGGCGGC -> TGAGAAGTTAGCGGCGGCA
TGAGAAGTTAGCGGCGGCA -> GAGAAGTTAGCGGCGGCAT
TCAAACGTCGAGTTATCCA -> CAAACGTCGAGTTATCCAA
CAAACGTCGAGTTATCCAA -> AAACGTCGAGTTATCCAAA
TTACGCACATACTGAATGG -> TACGCACATACTGAATGGA
TACGCACATACTGAATGGA -> ACGCACATACTGAATGGAC
GAGAAGTTAGCGGCGGCAT -> AGAAGTTAGCGGCGGCATA
TACTCTAACTAGCAGGCAG -> ACTCTAACTAGCAGGCAGG
ACTCTAACTAGCAGGCAGG -> CTCTAACTAGCAGGCAGGG
TGTTGCAAAACATTGAACT -> GTTGCAAAACATTGAACTC
CGTGCCTAAAAACTAGCAC -> GTGCCTAAAAACTAGCACG
ATGACCAGTATAATTCAGC -> TGACCAGTATAATTCAGCT
TGACCAGTATAATTCAGCT -> GACCAGTATAATTCAGCTC
AACGCTTGGCCAGGACACA -> ACGCTTGGCCAGGACACAC
ACGCTTGGCCAGGACACAC -> CGCTTGGCCAGGACACACC
ATGGCGCGTACAAGATAAG -> TGGCGCGTACAAGATAAGC
TGGCGCGTACAAGATAAGC -> GGCGCGTACAAGATAAGCC
CGAGTAGTTGTCTCCTCTT -> GAGTAGTTGTCTCCTCTTC
GAGTAGTTGTCTCCTCTTC -> AGTAGTTGTCTCCTCTTCT
AGCCATGGCGACCTTCAAT -> GCCATGGCGACCTTCAATA
ACACTCGCAATTAGTTGTG -> CACTCGCAATTAGTTGTGT
CACTCGCAATTAGTTGTGT -> ACTCGCAATTAGTTGTGTT
AGTTGTGTTCCGACCTTCC -> GTTGTGTTCCGACCTTCCG
GGGATAACTAATCATTTTA -> GGATAACTAATCATTTTAC
GTCTTGGGGAGGTTTCGAG -> TCTTGGGGAGGTTTCGAGC
TCTTGGGGAGGTTTCGAGC -> CTTGGGGAGGTTTCGAGCC
GTTACCGTAAGCTCTCCTG -> TTACCGTAAGCTCTCCTGG
TTACCGTAAGCTCTCCTGG -> TACCGTAAGCTCTCCTGGT
TATATTGCGACCTTCTACT -> ATATTGCGACCTTCTACTC
GAACGACTCGGATAAAATA -> AACGACTCGGATAAAATAA
TAATATGCTACAAACTATC -> AATATGCTACAAACTATCA
CTCCGGCACTGGGACCTTC -> TCCGGCACTGGGACCTTCG
ACTCAAACGTCGAGTTATC -> CTCAAACGTCGAGTTATCC
CTCAAACGTCGAGTTATCC -> TCAAACGTCGAGTTATCCA
TCGCATGGTCACGTTCGGT -> CGCATGGTCACGTTCGGTC
CGCATGGTCACGTTCGGTC -> GCATGGTCACGTTCGGTCA
CTACAAACTATCATCCCTG -> TACAAACTATCATCCCTGG
TACAAACTATCATCCCTGG -> ACAAACTATCATCCCTGGT
GCACGGACCCCAAGCTACT -> CACGGACCCCAAGCTACTT
CACGGACCCCAAGCTACTT -> ACGGACCCCAAGCTACTTA
GACTCACATTTCTTGTTAG -> ACTCACATTTCTTGTTAGC
ACTCACATTTCTTGTTAGC -> CTCACATTTCTTGTTAGCT
CTATCGGGATCCTGCCGTC -> TATCGGGATCCTGCCGTCC
TATCGGGATCCTGCCGTCC -> ATCGGGATCCTGCCGTCCT
GCGTAGGTTCATCCCACGG -> CGTAGGTTCATCCCACGGG
CGTAGGTTCATCCCACGGG -> GTAGGTTCATCCCACGGGG
ATCGGGATCCTGCCGTCCT -> TCGGGATCCTGCCGTCCTC
TCGGGATCCTGCCGTCCTC -> CGGGATCCTGCCGTCCTCG
AGTTTGCAGCTTATACATC -> GTTTGCAGCTTATACATCT
GTTTGCAGCTTATACATCT -> TTTGCAGCTTATACATCTG
GACGGGATGGCAGCGGTTG -> ACGGGATGGCAGCGGTTGA
GCTTTCACTGTGCCGGTTA -> CTTTCACTGTGCCGGTTAC
GGATTGCCTGCTTGTCAAC -> GATTGCCTGCTTGTCAACT
GATTGCCTGCTTGTCAACT -> ATTGCCTGCTTGTCAACTA
TGTTCCGACCTTCCGGACT -> GTTCCGACCTTCCGGACTG
GAATACCTGTCCCGCACGG -> AATACCTGTCCCGCACGGC
AATACCTGTCCCGCACGGC -> ATACCTGTCCCGCACGGCG
GGACCCCAAGCTACTTAAA -> GACCCCAAGCTACTTAAAC
GACCCCAAGCTACTTAAAC -> ACCCCAAGCTACTTAAACT
TACCATATTAGCCCTCGCC -> ACCATATTAGCCCTCGCCT
ACCATATTAGCCCTCGCCT -> CCATATTAGCCCTCGCCTG
GATTCTGGTTGAACCACTG -> ATTCTGGTTGAACCACTGT
GCGAGTAGTTGTCTCCTCT -> CGAGTAGTTGTCTCCTCTT
ATCAAGCAGGGCTGGAGAA -> TCAAGCAGGGCTGGAGAAT
TCAAGCAGGGCTGGAGAAT -> CAAGCAGGGCTGGAGAATT
TCGTCCTGCCTTCGTAGGG -> CGTCCTGCCTTCGTAGGGT
CGTCCTGCCTTCGTAGGGT -> GTCCTGCCTTCGTAGGGTA
GACTGTCTGCTCTATTTCA -> ACTGTCTGCTCTATTTCAT
ACTGTCTGCTCTATTTCAT -> CTGTCTGCTCTATTTCATG
CTCTTACACTGAAAAATTG -> TCTTACACTGAAAAATTGA
TCTTACACTGAAAAATTGA -> CTTACACTGAAAAATTGAA
AAACCGTACCATATTAGCC -> AACCGTACCATATTAGCCC
TAATGCACATCCACATCGC -> AATGCACATCCACATCGCG
AGCATCTTCTACTTAAGAC -> GCATCTTCTACTTAAGACA
GCATCTTCTACTTAAGACA -> CATCTTCTACTTAAGACAT
AAATAAGATGTTTGACTAA -> AATAAGATGTTTGACTAAC
GGTTGAACCACTGTCATAC -> GTTGAACCACTGTCATACT
GTTGAACCACTGTCATACT -> TTGAACCACTGTCATACTG
ACCTTCTACTCAGATCTCC -> CCTTCTACTCAGATCTCCA
CAGGCACACACGCGATCTG -> AGGCACACACGCGATCTGC
AGTGAAGTTCTACCAATAG -> GTGAAGTTCTACCAATAGT
GTGAAGTTCTACCAATAGT -> TGAAGTTCTACCAATAGTT
TTTGACTAACGTGATACCA -> TTGACTAACGTGATACCAA
CCTCCGGCACTGGGACCTT -> CTCCGGCACTGGGACCTTC
AACTTAACTAATGGTGTAT -> ACTTAACTAATGGTGTATT
TCAAACTATCATCCCTGGT -> CAAACTATCATCCCTGGTC
CCTTGGAATGGTATGGTTT -> CTTGGAATGGTATGGTTTT
CTTGGAATGGTATGGTTTT -> TTGGAATGGTATGGTTTTA
CCTGCCTTCGTAGGGTATA -> CTGCCTTCGTAGGGTATAG
CCTGTTAAGTGTTCCTTCG -> CTGTTAAGTGTTCCTTCGC
CTGTTAAGTGTTCCTTCGC -> TGTTAAGTGTTCCTTCGCT
TCTGCTCTATTTCATGCTA -> CTGCTCTATTTCATGCTAC
CTGCTCTATTTCATGCTAC -> TGCTCTATTTCATGCTACT
CTCTAGCTGATCCCATCTC -> TCTAGCTGATCCCATCTCG
CCTGACTCGCCCGTACGCC -> CTGACTCGCCCGTACGCCT
CTGACTCGCCCGTACGCCT -> TGACTCGCCCGTACGCCTT
TCTCGTCCTGCCTTCGTAG -> CTCGTCCTGCCTTCGTAGG
CTCGTCCTGCCTTCGTAGG -> TCGTCCTGCCTTCGTAGGG
GCCTTGGACCAAGGTCGGA -> CCTTGGACCAAGGTCGGAG
TGGTTTTAAAAACTAGCAC -> GGTTTTAAAAACTAGCACG
CGGTAGTTAAGGTGAGAAC -> GGTAGTTAAGGTGAGAACA
GGTAGTTAAGGTGAGAACA -> GTAGTTAAGGTGAGAACAT
ACAAGCCTGAGTGCTTTCA -> CAAGCCTGAGTGCTTTCAC
CAAGCCTGAGTGCTTTCAC -> AAGCCTGAGTGCTTTCACT
GGCTGCGTTGTATTCCTCA -> GCTGCGTTGTATTCCTCAA
ATCCAAATCGCCCTCGCAG -> TCCAAATCGCCCTCGCAGT
GCTAAGGTGACCAATATAG -> CTAAGGTGACCAATATAGG
CTAAGGTGACCAATATAGG -> TAAGGTGACCAATATAGGT
TTGTGACTGAACTTTTGAT -> TGTGACTGAACTTTTGATG
TGCACTTGCGAAGTAATAC -> GCACTTGCGAAGTAATACC
GCACTTGCGAAGTAATACC -> CACTTGCGAAGTAATACCT
AAGCCTGAGTGCTTTCACT -> AGCCTGAGTGCTTTCACTG
TCCAGGCACACACGCGATC -> CCAGGCACACACGCGATCT
CCAGGCACACACGCGATCT -> CAGGCACACACGCGATCTG
AGAAAAGCAGAATACAGAT -> GAAAAGCAGAATACAGATA
TACTTGTGAATCAAGCAGG -> ACTTGTGAATCAAGCAGGG
CCGGGATATGCGTACTCAA -> CGGGATATGCGTACTCAAA
AGGCGAGTGACCTTGGAAT -> GGCGAGTGACCTTGGAATG
GGCGAGTGACCTTGGAATG -> GCGAGTGACCTTGGAATGG
CAGATCTCCAGGCACACAC -> AGATCTCCAGGCACACACG
TGGTTGCTACTCTAACTAG -> GGTTGCTACTCTAACTAGC
ATCCCTGGTCCCGTAAAGC -> TCCCTGGTCCCGTAAAGCA
TCCCTGGTCCCGTAAAGCA -> CCCTGGTCCCGTAAAGCAC
CCTGGTCCGAGTGCAACTT -> CTGGTCCGAGTGCAACTTG
CTGGTCCGAGTGCAACTTG -> TGGTCCGAGTGCAACTTGT
GTTGTATTCCTCAAGCCGG -> TTGTATTCCTCAAGCCGGG
TAGTACGCCTTTAGTAATT -> AGTACGCCTTTAGTAATTC
CCCCGAGTGGCACTGCCTT -> CCCGAGTGGCACTGCCTTA
CCTAGCCTTTAATCATCAC -> CTAGCCTTTAATCATCACC
GAGAACATACGACAGCGGA -> AGAACATACGACAGCGGAG
AGAACATACGACAGCGGAG -> GAACATACGACAGCGGAGG
CGAAGTAATACCTCCTCGT -> GAAGTAATACCTCCTCGTA
GAAGTAATACCTCCTCGTA -> AAGTAATACCTCCTCGTAT
GAATGGACGCTAGCTTGCC -> AATGGACGCTAGCTTGCCA
TGCGTAGGGGTATATTGCG -> GCGTAGGGGTATATTGCGA
GCGTAGGGGTATATTGCGA -> CGTAGGGGTATATTGCGAC
GGGTTAAGTTCTACTCCTC -> GGTTAAGTTCTACTCCTCT
GGTTAAGTTCTACTCCTCT -> GTTAAGTTCTACTCCTCTT
ACCCCTAGCCTTTAATCAT -> CCCCTAGCCTTTAATCATC
CGGCATAGACCGTAAAAAC -> GGCATAGACCGTAAAAACT
GGCATAGACCGTAAAAACT -> GCATAGACCGTAAAAACTA
TGCCGTCCTCGTCTTGAAA -> GCCGTCCTCGTCTTGAAAG
AAAGTTTGCAGCTTATACA -> AAGTTTGCAGCTTATACAT
AAGTTTGCAGCTTATACAT -> AGTTTGCAGCTTATACATC
CTTCAAGGCGAGTGACCTT -> TTCAAGGCGAGTGACCTTG
AGCCCCTAGGCGTAGGTTC -> GCCCCTAGGCGTAGGTTCA
CACGCGCTTACAAATTAAT -> ACGCGCTTACAAATTAATA
TAAAACGACACGCGCTTAC -> AAAACGACACGCGCTTACA
AAAACGACACGCGCTTACA -> AAACGACACGCGCTTACAA
CAATGAACGACTCGGATAA -> AATGAACGACTCGGATAAA
AAAAACTAGCACGGACCAC -> AAAACTAGCACGGACCACG
AAAACTAGCACGGACCACG -> AAACTAGCACGGACCACGT
AATATGCTACAAACTATCA -> ATATGCTACAAACTATCAT
GCCATGGCGACCTTCAATA -> CCATGGCGACCTTCAATAG
AACACTCGCAATTAGTTGT -> ACACTCGCAATTAGTTGTG
ACGGAGCCCCTAGGCGTAG -> CGGAGCCCCTAGGCGTAGG
ATACCTCCTCGTATTCAAG -> TACCTCCTCGTATTCAAGC
TACCTCCTCGTATTCAAGC -> ACCTCCTCGTATTCAAGCA
TGAAAGGTTTTGAGAAGTT -> GAAAGGTTTTGAGAAGTTG
TCGCCCTCGCAGTCGGCTG -> CGCCCTCGCAGTCGGCTGG
CTTGTTAGCTACCCACCTA -> TTGTTAGCTACCCACCTAC
CGTACCATATTAGCCCTCG -> GTACCATATTAGCCCTCGC
AACTAATCATTTTACTAGA -> ACTAATCATTTTACTAGAG
ACTAATCATTTTACTAGAG -> CTAATCATTTTACTAGAGC
TTGATGGGGGTGCTGCTCC -> TGATGGGGGTGCTGCTCCG
TGATGGGGGTGCTGCTCCG -> GATGGGGGTGCTGCTCCGC
GGTATGGTTTTAAAAACTA -> GTATGGTTTTAAAAACTAG
GACCCTCCGGCACTGGGAC -> ACCCTCCGGCACTGGGACC
ACCCTCCGGCACTGGGACC -> CCCTCCGGCACTGGGACCT
ACAGATAACCCGCTGGCAC -> CAGATAACCCGCTGGCACG
CAGATAACCCGCTGGCACG -> AGATAACCCGCTGGCACGA
TGAACCACTGTCATACTGA -> GAACCACTGTCATACTGAT
GAACCACTGTCATACTGAT -> AACCACTGTCATACTGATC
GTGCAGCTAGTGAAGTTCT -> TGCAGCTAGTGAAGTTCTA
TGCAGCTAGTGAAGTTCTA -> GCAGCTAGTGAAGTTCTAC
GGCCAGGACACACCCAATT -> GCCAGGACACACCCAATTG
GCCAGGACACACCCAATTG -> CCAGGACACACCCAATTGA
CATACTGAATGGACGCTAG -> ATACTGAATGGACGCTAGC
ATACTGAATGGACGCTAGC -> TACTGAATGGACGCTAGCT
TACGAAATAAGATGTTTGA -> ACGAAATAAGATGTTTGAC
ACGAAATAAGATGTTTGAC -> CGAAATAAGATGTTTGACT
ACTGAATGGACGCTAGCTT -> CTGAATGGACGCTAGCTTG
AAGGTCGGAGCGGATTGCC -> AGGTCGGAGCGGATTGCCT
AGCACGTGCCTAAAAACTA -> GCACGTGCCTAAAAACTAG
TTGTGAATCAAGCAGGGCT -> TGTGAATCAAGCAGGGCTG
CCTACCGAACGCTTGGCCA -> CTACCGAACGCTTGGCCAG
CGCCTGTTGCAAAACATTG -> GCCTGTTGCAAAACATTGA
TGCTACTCTAACTAGCAGG -> GCTACTCTAACTAGCAGGC
AGTTAAGGTGAGAACATAC -> GTTAAGGTGAGAACATACG
TAGCCCTCGCCTGAGCGCT -> AGCCCTCGCCTGAGCGCTT
AGCCCTCGCCTGAGCGCTT -> GCCCTCGCCTGAGCGCTTG
GCTTGAGAAGTTAGCGGCG -> CTTGAGAAGTTAGCGGCGG
CTTGAGAAGTTAGCGGCGG -> TTGAGAAGTTAGCGGCGGC
TGCTGGGTTAAGTTCTACT -> GCTGGGTTAAGTTCTACTC
GCTGGGTTAAGTTCTACTC -> CTGGGTTAAGTTCTACTCC
CTCCAGGCACACACGCGAT -> TCCAGGCACACACGCGATC
GACCTTCCGGACTGCGCGA -> ACCTTCCGGACTGCGCGAG
ACCTTCCGGACTGCGCGAG -> CCTTCCGGACTGCGCGAGT
CGACGCCCCGCAACCCCTA -> GACGCCCCGCAACCCCTAG
TTCGTAGGGTATAGTAATT -> TCGTAGGGTATAGTAATTC
TCGTAGGGTATAGTAATTC -> CGTAGGGTATAGTAATTCT
GCGAGTGACCTTGGAATGG -> CGAGTGACCTTGGAATGGT
CGAGTGACCTTGGAATGGT -> GAGTGACCTTGGAATGGTA
CAGTCAATGAACGACTCGG -> AGTCAATGAACGACTCGGA
ATAAACCGTACCATATTAG -> TAAACCGTACCATATTAGC
ATAAGCCTACGGCGCCACC -> TAAGCCTACGGCGCCACCC
TAAGCCTACGGCGCCACCC -> AAGCCTACGGCGCCACCCA
AGGAACTTAACTAATGGTG -> GGAACTTAACTAATGGTGT
GGAACTTAACTAATGGTGT -> GAACTTAACTAATGGTGTA
GTTGCTACTCTAACTAGCA -> TTGCTACTCTAACTAGCAG
TTGCTACTCTAACTAGCAG -> TGCTACTCTAACTAGCAGG
TTCCGGACTGCGCGAGTAG -> TCCGGACTGCGCGAGTAGT
ACCAATAGTTGCGTAGGGG -> CCAATAGTTGCGTAGGGGT
ATGGTGTATTTGAAGACTC -> TGGTGTATTTGAAGACTCC
CGGCACCACGGTAGTCGAA -> GGCACCACGGTAGTCGAAC
ACCTACCGAACGCTTGGCC -> CCTACCGAACGCTTGGCCA
TCGGAGCGGATTGCCTGCT -> CGGAGCGGATTGCCTGCTT
CGGAGCGGATTGCCTGCTT -> GGAGCGGATTGCCTGCTTG
CTAGTCGTAGAGCCTGTTA -> TAGTCGTAGAGCCTGTTAA
AGCCTGAGTGCTTTCACTG -> GCCTGAGTGCTTTCACTGT
ATACGACAGCGGAGGCCTC -> TACGACAGCGGAGGCCTCC
TACGACAGCGGAGGCCTCC -> ACGACAGCGGAGGCCTCCA
TGTCTGCTCTATTTCATGC -> GTCTGCTCTATTTCATGCT
GTCTGCTCTATTTCATGCT -> TCTGCTCTATTTCATGCTA
TTTGATGGTTGCTACTCTA -> TTGATGGTTGCTACTCTAA
CCGAGTGCAACTTGTTTCC -> CGAGTGCAACTTGTTTCCG
GTGAAGTGGCCACTTCGCT -> TGAAGTGGCCACTTCGCTG
TTGCAGCTTATACATCTGT -> TGCAGCTTATACATCTGTT
TGCAGCTTATACATCTGTT -> GCAGCTTATACATCTGTTA
TGATACCAACTAGCGATTC -> GATACCAACTAGCGATTCT
CCCTAAAACGACACGCGCT -> CCTAAAACGACACGCGCTT
AGCTCTCCTGGTTTAAAAT -> GCTCTCCTGGTTTAAAATA
TAAAAACTAGCACGGACCT -> AAAAACTAGCACGGACCTA
AAGCCTACGGCGCCACCCA -> AGCCTACGGCGCCACCCAG
AGCCTACGGCGCCACCCAG -> GCCTACGGCGCCACCCAGC
TTGGGGAGGTTTCGAGCCC -> TGGGGAGGTTTCGAGCCCA
TGGGGAGGTTTCGAGCCCA -> GGGGAGGTTTCGAGCCCAA
GCAGCTAGTGAAGTTCTAC -> CAGCTAGTGAAGTTCTACC
CAGCTAGTGAAGTTCTACC -> AGCTAGTGAAGTTCTACCA
CGGATACTGACGGGATGGC -> GGATACTGACGGGATGGCA
GGATACTGACGGGATGGCA -> GATACTGACGGGATGGCAG
CTGACGGGATGGCAGCGGT -> TGACGGGATGGCAGCGGTT
TGACGGGATGGCAGCGGTT -> GACGGGATGGCAGCGGTTG
GAACTTAACTAATGGTGTA -> AACTTAACTAATGGTGTAT
CGTTCGGTCAACGACAAGT -> GTTCGGTCAACGACAAGTT
CATGACCAGTATAATTCAG -> ATGACCAGTATAATTCAGC
GAACGCTTGGCCAGGACAC -> AACGCTTGGCCAGGACACA
ACGTGATACCAACTAGCGA -> CGTGATACCAACTAGCGAT
CAAGGCGAGTGACCTTGGA -> AAGGCGAGTGACCTTGGAA
AAGGCGAGTGACCTTGGAA -> AGGCGAGTGACCTTGGAAT
GAGGTTTCGAGCCCAATAA -> AGGTTTCGAGCCCAATAAA
TGGGGATAACTAATCATTT -> GGGGATAACTAATCATTTT
ACTATCATCCCTGGTCCCA -> CTATCATCCCTGGTCCCAG
CTATCATCCCTGGTCCCAG -> TATCATCCCTGGTCCCAGG
TGACCAATATAGGTTTTGA -> GACCAATATAGGTTTTGAA
CGAGTGCAACTTGTTTCCG -> GAGTGCAACTTGTTTCCGA
GAGTGCAACTTGTTTCCGA -> AGTGCAACTTGTTTCCGAG
CGACACGCGCTTACAAATT -> GACACGCGCTTACAAATTA
GGGAGTCCCCAGTCAATGA -> GGAGTCCCCAGTCAATGAA
GGAGTCCCCAGTCAATGAA -> GAGTCCCCAGTCAATGAAC
ACTCGCAATTAGTTGTGTT -> CTCGCAATTAGTTGTGTTC
CTCGCAATTAGTTGTGTTC -> TCGCAATTAGTTGTGTTCC
CCGAGGAGCCAGGAACTTA -> CGAGGAGCCAGGAACTTAA
CGAGGAGCCAGGAACTTAA -> GAGGAGCCAGGAACTTAAC
TCTAGCGGTGCGAAAAATG -> CTAGCGGTGCGAAAAATGG
CCAATAAAAACTAGCACGG -> CAATAAAAACTAGCACGGA
CAATAAAAACTAGCACGGA -> AATAAAAACTAGCACGGAC
CGTGGGCTTGTCAAACTAT -> GTGGGCTTGTCAAACTATC
GTGGGCTTGTCAAACTATC -> TGGGCTTGTCAAACTATCA
CATACGACAGCGGAGGCCT -> ATACGACAGCGGAGGCCTC
ATACCTGTCCCGCACGGCG -> TACCTGTCCCGCACGGCGT
TACCTGTCCCGCACGGCGT -> ACCTGTCCCGCACGGCGTT
GACATGACCAGTATAATTC -> ACATGACCAGTATAATTCA
ACATGACCAGTATAATTCA -> CATGACCAGTATAATTCAG
TGACTGAACTTTTGATGGT -> GACTGAACTTTTGATGGTT
GACTGAACTTTTGATGGTT -> ACTGAACTTTTGATGGTTG
ACCTGCGCAAACAAAGTTT -> CCTGCGCAAACAAAGTTTG
CCTGCGCAAACAAAGTTTG -> CTGCGCAAACAAAGTTTGC
CTGTCATACTGATCCTAGT -> TGTCATACTGATCCTAGTC
TGTCATACTGATCCTAGTC -> GTCATACTGATCCTAGTCG
AAACTAGCACGGACCTAAT -> AACTAGCACGGACCTAATA
TGAGAAGTTGGGAATACTC -> GAGAAGTTGGGAATACTCC
GCTACCCACCTACCGAACG -> CTACCCACCTACCGAACGC
GTCGAGTTATCCAAATCGC -> TCGAGTTATCCAAATCGCC
TCGAGTTATCCAAATCGCC -> CGAGTTATCCAAATCGCCC
AATATCTCTAGCTGATCCC -> ATATCTCTAGCTGATCCCA
ATAGTAATTCTGAGCATAT -> TAGTAATTCTGAGCATATA
GGGTATAGTAATTCTGAGC -> GGTATAGTAATTCTGAGCA
GGTATAGTAATTCTGAGCA -> GTATAGTAATTCTGAGCAT
CAGGACACACCCAATTGAC -> AGGACACACCCAATTGACT
CTGCGCAAACAAAGTTTGC -> TGCGCAAACAAAGTTTGCA
GATACCAACTAGCGATTCT -> ATACCAACTAGCGATTCTG
CTTACACTGAAAAATTGAA -> TTACACTGAAAAATTGAAA
TTACACTGAAAAATTGAAA -> TACACTGAAAAATTGAAAG
CGGGGAGTCCCCAGTCAAT -> GGGGAGTCCCCAGTCAATG
AATGGACGCTAGCTTGCCA -> ATGGACGCTAGCTTGCCAT
CGAACGCTTGGCCAGGACA -> GAACGCTTGGCCAGGACAC
GACCTAATATGCTACAAAC -> ACCTAATATGCTACAAACT
CCTCAAGCCGGGATATGCG -> CTCAAGCCGGGATATGCGT
CTCAAGCCGGGATATGCGT -> TCAAGCCGGGATATGCGTA
TACTGAATGGACGCTAGCT -> ACTGAATGGACGCTAGCTT
TCACATTTCTTGTTAGCTA -> CACATTTCTTGTTAGCTAC
GCTGGAGAATTTCTAGCGG -> CTGGAGAATTTCTAGCGGT
CTGGAGAATTTCTAGCGGT -> TGGAGAATTTCTAGCGGTG
CTGGGTTAAGTTCTACTCC -> TGGGTTAAGTTCTACTCCT
AACTCGGCACCACGGTAGT -> ACTCGGCACCACGGTAGTC
ATTGAAAGGATGCTGTTTG -> TTGAAAGGATGCTGTTTGG
ATTTCTTGTTAGCTACCCA -> TTTCTTGTTAGCTACCCAC
TTTCTTGTTAGCTACCCAC -> TTCTTGTTAGCTACCCACC
TTAATCATCACCCCTAAAA -> TAATCATCACCCCTAAAAC
TAATCATCACCCCTAAAAC -> AATCATCACCCCTAAAACG
AACGCACCCACGAAATGAG -> ACGCACCCACGAAATGAGA
ACGCACCCACGAAATGAGA -> CGCACCCACGAAATGAGAA
CGGCTGGGGATAACTAATC -> GGCTGGGGATAACTAATCA
GCTCACAAAGAAATCTCGT -> CTCACAAAGAAATCTCGTC
CCACTTCGCTGTACAAAGA -> CACTTCGCTGTACAAAGAA
CACTTCGCTGTACAAAGAA -> ACTTCGCTGTACAAAGAAC
GATAACCCGCTGGCACGAC -> ATAACCCGCTGGCACGACT
ATAACCCGCTGGCACGACT -> TAACCCGCTGGCACGACTC
TTCTACTCAGATCTCCAGG -> TCTACTCAGATCTCCAGGC
TAGGGGTATATTGCGACCT -> AGGGGTATATTGCGACCTT
GCAACCCAGATATACACTT -> CAACCCAGATATACACTTG
AGCACGGACCCCAAGCTAC -> GCACGGACCCCAAGCTACT
AACTACCATAGCAATACAC -> ACTACCATAGCAATACACG
CCTTCGGGGCATATTACCA -> CTTCGGGGCATATTACCAG
CTTCGGGGCATATTACCAG -> TTCGGGGCATATTACCAGC
CTATCATCCCTGGTCCCGC -> TATCATCCCTGGTCCCGCC
CGCCCCGCAACCCCTAGCC -> GCCCCGCAACCCCTAGCCT
TCAAGCAATGCGTGTCCCA -> CAAGCAATGCGTGTCCCAC
TTTACGAAATAAGATGTTT -> TTACGAAATAAGATGTTTG
TTACGAAATAAGATGTTTG -> TACGAAATAAGATGTTTGA
TTCAAGCAATGCGTGTCCC -> TCAAGCAATGCGTGTCCCA
ATCTCGTCCTGCCTTCGTA -> TCTCGTCCTGCCTTCGTAG
GTAGTCGAACACTCGCAAT -> TAGTCGAACACTCGCAATT
GGGGAGTCCCCAGTCAATG -> GGGAGTCCCCAGTCAATGA
ATTGCCTGCTTGTCAACTA -> TTGCCTGCTTGTCAACTAC
TTGCCTGCTTGTCAACTAC -> TGCCTGCTTGTCAACTACC
ACTCAGATCTCCAGGCACA -> CTCAGATCTCCAGGCACAC
CTCAGATCTCCAGGCACAC -> TCAGATCTCCAGGCACACA
TATAGTAATTCTGAGCATA -> ATAGTAATTCTGAGCATAT
ATATGCACTTGCGAAGTAA -> TATGCACTTGCGAAGTAAT
ACCCAATTGACTCAGCACC -> CCCAATTGACTCAGCACCG
CACATCCACATCGCGGATA -> ACATCCACATCGCGGATAG
ACATCCACATCGCGGATAG -> CATCCACATCGCGGATAGG
CCACGGTAGTCGAACACTC -> CACGGTAGTCGAACACTCG
CACGGTAGTCGAACACTCG -> ACGGTAGTCGAACACTCGC
CCCAAGCTACTTAAACTAT -> CCAAGCTACTTAAACTATC
CCAAGCTACTTAAACTATC -> CAAGCTACTTAAACTATCA
AGATAACCCGCTGGCACGA -> GATAACCCGCTGGCACGAC
TATTTCATGCTACTAGTTT -> ATTTCATGCTACTAGTTTG
ATTTCATGCTACTAGTTTG -> TTTCATGCTACTAGTTTGT
CCGCACGGCGTTCCCCGAG -> CGCACGGCGTTCCCCGAGT
CCGTACGCCTTCCGTGCAG -> CGTACGCCTTCCGTGCAGC
CGTACGCCTTCCGTGCAGC -> GTACGCCTTCCGTGCAGCT
CCTAGTCGTAGAGCCTGTT -> CTAGTCGTAGAGCCTGTTA
AGAACAAATATCTCTAGCT -> GAACAAATATCTCTAGCTG
GAACAAATATCTCTAGCTG -> AACAAATATCTCTAGCTGA
TTTCATGCTACTAGTTTGT -> TTCATGCTACTAGTTTGTG
CAACCCAGATATACACTTG -> AACCCAGATATACACTTGC
TCGGTCGGGGAGTCCCCAG -> CGGTCGGGGAGTCCCCAGT
CGGTCGGGGAGTCCCCAGT -> GGTCGGGGAGTCCCCAGTC
CTGCTTGTCAACTACCATA -> TGCTTGTCAACTACCATAG
TGCTTGTCAACTACCATAG -> GCTTGTCAACTACCATAGC
AAAGGATGCTGTTTGGCTG -> AAGGATGCTGTTTGGCTGC
ACTAGCACGGACCCCAAGC -> CTAGCACGGACCCCAAGCT
CTAGCACGGACCCCAAGCT -> TAGCACGGACCCCAAGCTA
GCACACACGCGATCTGCAA -> CACACACGCGATCTGCAAC
CCCCTAGGCGTAGGTTCAT -> CCCTAGGCGTAGGTTCATC
GACTGCGCGAGTAGTTGTC -> ACTGCGCGAGTAGTTGTCT
ACTGCGCGAGTAGTTGTCT -> CTGCGCGAGTAGTTGTCTC
ACAAAGAACAAATATCTCT -> CAAAGAACAAATATCTCTA
CAAAGAACAAATATCTCTA -> AAAGAACAAATATCTCTAG
GGGGACAAGCCTGAGTGCT -> GGGACAAGCCTGAGTGCTT
AATCTCGTCCTGCCTTCGT -> ATCTCGTCCTGCCTTCGTA
TATTAGCCCTCGCCTGAGC -> ATTAGCCCTCGCCTGAGCG
ATTAGCCCTCGCCTGAGCG -> TTAGCCCTCGCCTGAGCGC
GCTTGGCCAGGACACACCC -> CTTGGCCAGGACACACCCA
CTTGGCCAGGACACACCCA -> TTGGCCAGGACACACCCAA
AACGATACGCCTGTTGCAA -> ACGATACGCCTGTTGCAAA
GCGGATTGCCTGCTTGTCA -> CGGATTGCCTGCTTGTCAA
CGGATTGCCTGCTTGTCAA -> GGATTGCCTGCTTGTCAAC
CTTCGTAGGGTATAGTAAT -> TTCGTAGGGTATAGTAATT
ATTGGGGAGTCTCTCATGG -> TTGGGGAGTCTCTCATGGC
TTGGGGAGTCTCTCATGGC -> TGGGGAGTCTCTCATGGCG
TGGGAATACTCCGAGTCCG -> GGGAATACTCCGAGTCCGC
GGGAATACTCCGAGTCCGC -> GGAATACTCCGAGTCCGCA
CAAGCAGGGCTGGAGAATT -> AAGCAGGGCTGGAGAATTT
CAATTAGTTGTGTTCCGAC -> AATTAGTTGTGTTCCGACC
AATTAGTTGTGTTCCGACC -> ATTAGTTGTGTTCCGACCT
GTAATTCCGGATACTGACG -> TAATTCCGGATACTGACGG
GAGCAACGCACCCACGAAA -> AGCAACGCACCCACGAAAT
GGACTGCGCGAGTAGTTGT -> GACTGCGCGAGTAGTTGTC
TGCAACTTGTTTCCGAGGA -> GCAACTTGTTTCCGAGGAG
GCAACTTGTTTCCGAGGAG -> CAACTTGTTTCCGAGGAGC
GAAAGGATGCTGTTTGGCT -> AAAGGATGCTGTTTGGCTG
GGTGCTGCTCCGCGATCAA -> GTGCTGCTCCGCGATCAAC
GTGCTGCTCCGCGATCAAC -> TGCTGCTCCGCGATCAACG
ACGCCTTTAGTAATTCCGG -> CGCCTTTAGTAATTCCGGA
GAGTGACCTTGGAATGGTA -> AGTGACCTTGGAATGGTAT
CTTCAATAGTACGCCTTTA -> TTCAATAGTACGCCTTTAG
CGTAGGGTATAGTAATTCT -> GTAGGGTATAGTAATTCTG
GTAGGGTATAGTAATTCTG -> TAGGGTATAGTAATTCTGA
ATCCCTGGTCCCAGGCAGG -> TCCCTGGTCCCAGGCAGGC
TCCCTGGTCCCAGGCAGGC -> CCCTGGTCCCAGGCAGGCA
ACGGACCCCAAGCTACTTA -> CGGACCCCAAGCTACTTAA
CGGACCCCAAGCTACTTAA -> GGACCCCAAGCTACTTAAA
TCCGGATACTGACGGGATG -> CCGGATACTGACGGGATGG
CCGGATACTGACGGGATGG -> CGGATACTGACGGGATGGC
ATCTTCTACTTAAGACATG -> TCTTCTACTTAAGACATGA
TCTTCTACTTAAGACATGA -> CTTCTACTTAAGACATGAC
AGATATACACTTGCTGGGT -> GATATACACTTGCTGGGTT
CGACTGTCTGCTCTATTTC -> GACTGTCTGCTCTATTTCA
TGTTACCGTAAGCTCTCCT -> GTTACCGTAAGCTCTCCTG
CCACCTGGTACTCGCGAGC -> CACCTGGTACTCGCGAGCA
AGCGGTGCGAAAAATGGTG -> GCGGTGCGAAAAATGGTGG
GGATAGGCGGGGGGTTGAT -> GATAGGCGGGGGGTTGATG
GATAGGCGGGGGGTTGATG -> ATAGGCGGGGGGTTGATGG
AACTAATGGTGTATTTGAA -> ACTAATGGTGTATTTGAAG
TCCGCGATCAACGATACGC -> CCGCGATCAACGATACGCC
CCGCGATCAACGATACGCC -> CGCGATCAACGATACGCCT
GTTCCGATTAAACTATCAT -> TTCCGATTAAACTATCATC
ATCGATTGGGGAGTCTCTC -> TCGATTGGGGAGTCTCTCA
TCGATTGGGGAGTCTCTCA -> CGATTGGGGAGTCTCTCAT
AATCGATTGGGGAGTCTCT -> ATCGATTGGGGAGTCTCTC
CACACGCGATCTGCAACCC -> ACACGCGATCTGCAACCCA
CCCTGGTCCCAGGCAGGCA -> CCTGGTCCCAGGCAGGCAA
ACTATCATCCCTGGTCCGA -> CTATCATCCCTGGTCCGAG
CTATCATCCCTGGTCCGAG -> TATCATCCCTGGTCCGAGT
GTCGAACACTCGCAATTAG -> TCGAACACTCGCAATTAGT
GTCATACTGATCCTAGTCG -> TCATACTGATCCTAGTCGT
AGTTATCCAAATCGCCCTC -> GTTATCCAAATCGCCCTCG
GACCAGTATAATTCAGCTC -> ACCAGTATAATTCAGCTCC
TGGTTGAACCACTGTCATA -> GGTTGAACCACTGTCATAC
CGATTGGGGAGTCTCTCAT -> GATTGGGGAGTCTCTCATG
GCCTGAGCGCTTGAGAAGT -> CCTGAGCGCTTGAGAAGTT
TTACTTGTGAATCAAGCAG -> TACTTGTGAATCAAGCAGG
CACCGACTGTCTGCTCTAT -> ACCGACTGTCTGCTCTATT
ATGGTGGACCTCTCTTACA -> TGGTGGACCTCTCTTACAC
TGGTGGACCTCTCTTACAC -> GGTGGACCTCTCTTACACT
TGATCCCATCTCGCATGGT -> GATCCCATCTCGCATGGTC
TGCTCTATTTCATGCTACT -> GCTCTATTTCATGCTACTA
CTCGCAGTCGGCTGGGGAT -> TCGCAGTCGGCTGGGGATA
TCGCAGTCGGCTGGGGATA -> CGCAGTCGGCTGGGGATAA
CCAATAGTTGCGTAGGGGT -> CAATAGTTGCGTAGGGGTA
CAATAGTTGCGTAGGGGTA -> AATAGTTGCGTAGGGGTAT
GGGCTTGTCAAACTATCAT -> GGCTTGTCAAACTATCATC
GGCTTGTCAAACTATCATC -> GCTTGTCAAACTATCATCC
TTCTACCAATAGTTGCGTA -> TCTACCAATAGTTGCGTAG
CTTCGCTAGCCGGTAGTTA -> TTCGCTAGCCGGTAGTTAA
TTCTAGCGGTGCGAAAAAT -> TCTAGCGGTGCGAAAAATG
ATTTACGAAATAAGATGTT -> TTTACGAAATAAGATGTTT
GCATAGACCGTAAAAACTA -> CATAGACCGTAAAAACTAG
CATAGACCGTAAAAACTAG -> ATAGACCGTAAAAACTAGC
GAGCCAGGAACTTAACTAA -> AGCCAGGAACTTAACTAAT
TCTACTTAAGACATGACCA -> CTACTTAAGACATGACCAG
CTACTTAAGACATGACCAG -> TACTTAAGACATGACCAGT
AACTAGCGATTCTGGTTGA -> ACTAGCGATTCTGGTTGAA
ACTAGCGATTCTGGTTGAA -> CTAGCGATTCTGGTTGAAC
GCACATCCACATCGCGGAT -> CACATCCACATCGCGGATA
TTAGCTACCCACCTACCGA -> TAGCTACCCACCTACCGAA
TAGCTACCCACCTACCGAA -> AGCTACCCACCTACCGAAC
TGGTCCCGTAAAGCACGTG -> GGTCCCGTAAAGCACGTGC
GGTCCCGTAAAGCACGTGC -> GTCCCGTAAAGCACGTGCC
ACAAATTAATATGCACTTG -> CAAATTAATATGCACTTGC
CCCACGGGGGACAAGCCTG -> CCACGGGGGACAAGCCTGA
ACTCGCGAGCATCTTCTAC -> CTCGCGAGCATCTTCTACT
CTCGCGAGCATCTTCTACT -> TCGCGAGCATCTTCTACTT
AGGTCGGAGCGGATTGCCT -> GGTCGGAGCGGATTGCCTG
TGAAGTTCTACCAATAGTT -> GAAGTTCTACCAATAGTTG
GAAGTTCTACCAATAGTTG -> AAGTTCTACCAATAGTTGC
TACCTGCGCAAACAAAGTT -> ACCTGCGCAAACAAAGTTT
GATGGGGGTGCTGCTCCGC -> ATGGGGGTGCTGCTCCGCG
AATATAGGTTTTGAAGGTG -> ATATAGGTTTTGAAGGTGA
TGGTCACGTTCGGTCAACG -> GGTCACGTTCGGTCAACGA
GGTCACGTTCGGTCAACGA -> GTCACGTTCGGTCAACGAC
GCTAGCTAAGGTGACCAAT -> CTAGCTAAGGTGACCAATA
CTAGCTAAGGTGACCAATA -> TAGCTAAGGTGACCAATAT
CAGGGACCTTCGAGAACTC -> AGGGACCTTCGAGAACTCC
AGGGACCTTCGAGAACTCC -> GGGACCTTCGAGAACTCCG
TCTACCAATAGTTGCGTAG -> CTACCAATAGTTGCGTAGG
CCATAGCAATACACGGAGC -> CATAGCAATACACGGAGCC
GAAATGAGAAAAGCAGAAT -> AAATGAGAAAAGCAGAATA
ATTTATATAATGCACATCC -> TTTATATAATGCACATCCA
CGCGATCAACGATACGCCT -> GCGATCAACGATACGCCTG
GCGATCAACGATACGCCTG -> CGATCAACGATACGCCTGT
GCTCCGCGATCAACGATAC -> CTCCGCGATCAACGATACG
CTCCGCGATCAACGATACG -> TCCGCGATCAACGATACGC
CCTGCTTGTCAACTACCAT -> CTGCTTGTCAACTACCATA
TAAAAACTAGCACGGACCA -> AAAAACTAGCACGGACCAC
TACGCCTTTAGTAATTCCG -> ACGCCTTTAGTAATTCCGG
GGGACAAGCCTGAGTGCTT -> GGACAAGCCTGAGTGCTTT
TCATGGCGCGTACAAGATA -> CATGGCGCGTACAAGATAA
CATGGCGCGTACAAGATAA -> ATGGCGCGTACAAGATAAG
CTGTCTGCTCTATTTCATG -> TGTCTGCTCTATTTCATGC
CTTGCGAAGTAATACCTCC -> TTGCGAAGTAATACCTCCT
TTGCGAAGTAATACCTCCT -> TGCGAAGTAATACCTCCTC
AACAATAAACCGTACCATA -> ACAATAAACCGTACCATAT
ACAATAAACCGTACCATAT -> CAATAAACCGTACCATATT
TACATCTGTTACCGTAAGC -> ACATCTGTTACCGTAAGCT
TAGTTTGTGACTGAACTTT -> AGTTTGTGACTGAACTTTT
GATATACACTTGCTGGGTT -> ATATACACTTGCTGGGTTA
ATATACACTTGCTGGGTTA -> TATACACTTGCTGGGTTAA
CTGCCTTATGCTTCGACGC -> TGCCTTATGCTTCGACGCT
GCACGTGCCTAAAAACTAG -> CACGTGCCTAAAAACTAGC
AAAATGGTGGACCTCTCTT -> AAATGGTGGACCTCTCTTA
AAATGGTGGACCTCTCTTA -> AATGGTGGACCTCTCTTAC
TCCTCAAGCCGGGATATGC -> CCTCAAGCCGGGATATGCG
TCTCTGATAAATAATCGAT -> CTCTGATAAATAATCGATT
GAGTCTTGGGGAGGTTTCG -> AGTCTTGGGGAGGTTTCGA
GGGACCTTCGGGGCATATT -> GGACCTTCGGGGCATATTA
TACTCGCGAGCATCTTCTA -> ACTCGCGAGCATCTTCTAC
TGACTCAGCACCGACTGTC -> GACTCAGCACCGACTGTCT
CGACTCGGATAAAATAACG -> GACTCGGATAAAATAACGA
CCAGGAACTTAACTAATGG -> CAGGAACTTAACTAATGGT
CCAGCCTTGGACCAAGGTC -> CAGCCTTGGACCAAGGTCG
CAGCCTTGGACCAAGGTCG -> AGCCTTGGACCAAGGTCGG
GTTTAAAATATAACAATAA -> TTTAAAATATAACAATAAA
TTTAAAATATAACAATAAA -> TTAAAATATAACAATAAAC
ATCATCCCTGGTCCCAGGC -> TCATCCCTGGTCCCAGGCA
GGCACTGGGACCTTCGGGG -> GCACTGGGACCTTCGGGGC
GACGCTAGCTAAGGTGACC -> ACGCTAGCTAAGGTGACCA
CTTGGGGAGGTTTCGAGCC -> TTGGGGAGGTTTCGAGCCC
TGGGTTAAGTTCTACTCCT -> GGGTTAAGTTCTACTCCTC
CCCTCGCAGTCGGCTGGGG -> CCTCGCAGTCGGCTGGGGA
CCTCGCAGTCGGCTGGGGA -> CTCGCAGTCGGCTGGGGAT
GTTCATCCCACGGGGGACA -> TTCATCCCACGGGGGACAA
TTAAGTTCTACTCCTCTTC -> TAAGTTCTACTCCTCTTCA
TAAGTTCTACTCCTCTTCA -> AAGTTCTACTCCTCTTCAA
GCAGGGGATACCTGCGCAA -> CAGGGGATACCTGCGCAAA
CAGGGGATACCTGCGCAAA -> AGGGGATACCTGCGCAAAC
GCGGCATAGACCGTAAAAA -> CGGCATAGACCGTAAAAAC
CGGATAGGCGGGGGGTTGA -> GGATAGGCGGGGGGTTGAT
TAACTAATCATTTTACTAG -> AACTAATCATTTTACTAGA
GCAGCTTATACATCTGTTA -> CAGCTTATACATCTGTTAC
ACATTTACGAAATAAGATG -> CATTTACGAAATAAGATGT
CATTTACGAAATAAGATGT -> ATTTACGAAATAAGATGTT
TTGGACCAAGGTCGGAGCG -> TGGACCAAGGTCGGAGCGG
TGGACCAAGGTCGGAGCGG -> GGACCAAGGTCGGAGCGGA
AAGCCGGGATATGCGTACT -> AGCCGGGATATGCGTACTC
CTCAGCACCGACTGTCTGC -> TCAGCACCGACTGTCTGCT
TTGAAGACTCCTATCGGGA -> TGAAGACTCCTATCGGGAT
CGTGTCCCACCTGGTACTC -> GTGTCCCACCTGGTACTCG
GATAAGCCTACGGCGCCAC -> ATAAGCCTACGGCGCCACC
CTCATGGCGCGTACAAGAT -> TCATGGCGCGTACAAGATA
CCAGGCAGGCAACATTTAC -> CAGGCAGGCAACATTTACG
CAGGCAGGCAACATTTACG -> AGGCAGGCAACATTTACGA
TCTGGTTGAACCACTGTCA -> CTGGTTGAACCACTGTCAT
CTGGTTGAACCACTGTCAT -> TGGTTGAACCACTGTCATA
TGTGAATCAAGCAGGGCTG -> GTGAATCAAGCAGGGCTGG
GTCGATTTATATAATGCAC -> TCGATTTATATAATGCACA
TCGATTTATATAATGCACA -> CGATTTATATAATGCACAT
CTCTAACTAGCAGGCAGGG -> TCTAACTAGCAGGCAGGGG
CCGCAGGGACCTTCGAGAA -> CGCAGGGACCTTCGAGAAC
GTATTTGAAGACTCCTATC -> TATTTGAAGACTCCTATCG
TATTTGAAGACTCCTATCG -> ATTTGAAGACTCCTATCGG
CGGACTGCGCGAGTAGTTG -> GGACTGCGCGAGTAGTTGT
AAGTTGGGAATACTCCGAG -> AGTTGGGAATACTCCGAGT
TAGCACGGACCCCAAGCTA -> AGCACGGACCCCAAGCTAC
AATAGTTGCGTAGGGGTAT -> ATAGTTGCGTAGGGGTATA
ATAGTTGCGTAGGGGTATA -> TAGTTGCGTAGGGGTATAT
TACAGATAACCCGCTGGCA -> ACAGATAACCCGCTGGCAC
AACCACTGTCATACTGATC -> ACCACTGTCATACTGATCC
ACCACTGTCATACTGATCC -> CCACTGTCATACTGATCCT
AAAAATTGAAAGGATGCTG -> AAAATTGAAAGGATGCTGT
AAAATTGAAAGGATGCTGT -> AAATTGAAAGGATGCTGTT
AGGTGACCAATATAGGTTT -> GGTGACCAATATAGGTTTT
GTACCATATTAGCCCTCGC -> TACCATATTAGCCCTCGCC
AGCTTGCCATGTCGATTTA -> GCTTGCCATGTCGATTTAT
GCTTGCCATGTCGATTTAT -> CTTGCCATGTCGATTTATA
TACACTGAAAAATTGAAAG -> ACACTGAAAAATTGAAAGG
ACACTGAAAAATTGAAAGG -> CACTGAAAAATTGAAAGGA
CTAACTAGCAGGCAGGGGA -> TAACTAGCAGGCAGGGGAT
ACGCGCTTACAAATTAATA -> CGCGCTTACAAATTAATAT
GTTGTCTCCTCTTCTCTGA -> TTGTCTCCTCTTCTCTGAT
TTGTCTCCTCTTCTCTGAT -> TGTCTCCTCTTCTCTGATA
CGGGGCATATTACCAGCCT -> GGGGCATATTACCAGCCTT
GGGGCATATTACCAGCCTT -> GGGCATATTACCAGCCTTG
TTAAGTGTTCCTTCGCTAG -> TAAGTGTTCCTTCGCTAGC
AAGTTAGCGGCGGCATAGA -> AGTTAGCGGCGGCATAGAC
TATCATCCCTGGTCCCGTA -> ATCATCCCTGGTCCCGTAA
CCCAATAAAAACTAGCACG -> CCAATAAAAACTAGCACGG
TTCTACTCCTCTTCAAGGC -> TCTACTCCTCTTCAAGGCG
TCTACTCCTCTTCAAGGCG -> CTACTCCTCTTCAAGGCGA
GCTTACAAATTAATATGCA -> CTTACAAATTAATATGCAC
GGCATATTACCAGCCTTGG -> GCATATTACCAGCCTTGGA
GCATATTACCAGCCTTGGA -> CATATTACCAGCCTTGGAC
ATAGGCGGGGGGTTGATGG -> TAGGCGGGGGGTTGATGGG
CGTTCCGATTAAACTATCA -> GTTCCGATTAAACTATCAT
CTGGCACGACTCACATTTC -> TGGCACGACTCACATTTCT
ATGGCGACCTTCAATAGTA -> TGGCGACCTTCAATAGTAC
GTTCTACTCCTCTTCAAGG -> TTCTACTCCTCTTCAAGGC
CGAGTTATCCAAATCGCCC -> GAGTTATCCAAATCGCCCT
GAGTTATCCAAATCGCCCT -> AGTTATCCAAATCGCCCTC
TACAAAGAACAAATATCTC -> ACAAAGAACAAATATCTCT
AGTCTCTCATGGCGCGTAC -> GTCTCTCATGGCGCGTACA
GTCTCTCATGGCGCGTACA -> TCTCTCATGGCGCGTACAA
GCCCGTACGCCTTCCGTGC -> CCCGTACGCCTTCCGTGCA
CCCGTACGCCTTCCGTGCA -> CCGTACGCCTTCCGTGCAG
TGAGAACATACGACAGCGG -> GAGAACATACGACAGCGGA
CGCTTGGCCAGGACACACC -> GCTTGGCCAGGACACACCC
ATAAAATAACGATGTTGAA -> TAAAATAACGATGTTGAAT
TAAAATAACGATGTTGAAT -> AAAATAACGATGTTGAATT
TCTAACTAGCAGGCAGGGG -> CTAACTAGCAGGCAGGGGA
CAGGAACTTAACTAATGGT -> AGGAACTTAACTAATGGTG
ATATTACCAGCCTTGGACC -> TATTACCAGCCTTGGACCA
TATTACCAGCCTTGGACCA -> ATTACCAGCCTTGGACCAA
GTGCGAAAAATGGTGGACC -> TGCGAAAAATGGTGGACCT
AGTGGCCACTTCGCTGTAC -> GTGGCCACTTCGCTGTACA
CATTTCTTGTTAGCTACCC -> ATTTCTTGTTAGCTACCCA
GAAAAATGGTGGACCTCTC -> AAAAATGGTGGACCTCTCT
AAAAATGGTGGACCTCTCT -> AAAATGGTGGACCTCTCTT
GCTGTACAAAGAACAAATA -> CTGTACAAAGAACAAATAT
CTGTACAAAGAACAAATAT -> TGTACAAAGAACAAATATC
GATACTGACGGGATGGCAG -> ATACTGACGGGATGGCAGC
CGATCTGCAACCCAGATAT -> GATCTGCAACCCAGATATA
GATCTGCAACCCAGATATA -> ATCTGCAACCCAGATATAC
CGGAGGCCTCCACGAGTCT -> GGAGGCCTCCACGAGTCTT
GTCAACTACCATAGCAATA -> TCAACTACCATAGCAATAC
TTCATGCTACTAGTTTGTG -> TCATGCTACTAGTTTGTGA
AGGTTTCGAGCCCAATAAA -> GGTTTCGAGCCCAATAAAA
GGTTTCGAGCCCAATAAAA -> GTTTCGAGCCCAATAAAAA
CCCCTAAAACGACACGCGC -> CCCTAAAACGACACGCGCT
GACTCAGCACCGACTGTCT -> ACTCAGCACCGACTGTCTG
ATTGAACTCGGCACCACGG -> TTGAACTCGGCACCACGGT
GGCCTCCACGAGTCTTGGG -> GCCTCCACGAGTCTTGGGG
GCCTCCACGAGTCTTGGGG -> CCTCCACGAGTCTTGGGGA
ATAATGCACATCCACATCG -> TAATGCACATCCACATCGC
TTGTTTCCGAGGAGCCAGG -> TGTTTCCGAGGAGCCAGGA
AGGTTTTGAAGGTGAAGTG -> GGTTTTGAAGGTGAAGTGG
GGTTTTGAAGGTGAAGTGG -> GTTTTGAAGGTGAAGTGGC
CCTGGTACTCGCGAGCATC -> CTGGTACTCGCGAGCATCT
GTTCGGTCAACGACAAGTT -> TTCGGTCAACGACAAGTTA
TTTGCAGCTTATACATCTG -> TTGCAGCTTATACATCTGT
TGCTACAAACTATCATCCC -> GCTACAAACTATCATCCCT
GCTACAAACTATCATCCCT -> CTACAAACTATCATCCCTG
AAACTAGCACGGACCACGT -> AACTAGCACGGACCACGTT
AACTAGCACGGACCACGTT -> ACTAGCACGGACCACGTTC
TATTCCTCAAGCCGGGATA -> ATTCCTCAAGCCGGGATAT
TTGCCATGTCGATTTATAT -> TGCCATGTCGATTTATATA
TGCCATGTCGATTTATATA -> GCCATGTCGATTTATATAA
GGGGGGTTGATGGGGGTGC -> GGGGGTTGATGGGGGTGCT
AGGCAGGCAACATTTACGA -> GGCAGGCAACATTTACGAA
CGACGCTAGCTAAGGTGAC -> GACGCTAGCTAAGGTGACC
AGCTACCCACCTACCGAAC -> GCTACCCACCTACCGAACG
GCTACTAGTTTGTGACTGA -> CTACTAGTTTGTGACTGAA
CTACTAGTTTGTGACTGAA -> TACTAGTTTGTGACTGAAC
AGACATGACCAGTATAATT -> GACATGACCAGTATAATTC
TATAAGTGACCCTCCGGCA -> ATAAGTGACCCTCCGGCAC
ATAAGTGACCCTCCGGCAC -> TAAGTGACCCTCCGGCACT
CAGCTTATACATCTGTTAC -> AGCTTATACATCTGTTACC
AGCTTATACATCTGTTACC -> GCTTATACATCTGTTACCG
CCGCGACGCCCCGCAACCC -> CGCGACGCCCCGCAACCCC
CTGATCCCATCTCGCATGG -> TGATCCCATCTCGCATGGT
AACTAGCACGGACCCCAAG -> ACTAGCACGGACCCCAAGC
GCAGGGCTGGAGAATTTCT -> CAGGGCTGGAGAATTTCTA
ATAACTAATCATTTTACTA -> TAACTAATCATTTTACTAG
CAAGCTACTTAAACTATCA -> AAGCTACTTAAACTATCAT
CCACATCGCGGATAGGCGG -> CACATCGCGGATAGGCGGG
ATACCTGCGCAAACAAAGT -> TACCTGCGCAAACAAAGTT
ATTCCGGATACTGACGGGA -> TTCCGGATACTGACGGGAT
TTCCGGATACTGACGGGAT -> TCCGGATACTGACGGGATG
CTCACATTTCTTGTTAGCT -> TCACATTTCTTGTTAGCTA
AGGCCTCCACGAGTCTTGG -> GGCCTCCACGAGTCTTGGG
GCCACTTCGCTGTACAAAG -> CCACTTCGCTGTACAAAGA
GCATGGTCACGTTCGGTCA -> CATGGTCACGTTCGGTCAA
CATGGTCACGTTCGGTCAA -> ATGGTCACGTTCGGTCAAC
GCGAAGTAATACCTCCTCG -> CGAAGTAATACCTCCTCGT
GACCAATATAGGTTTTGAA -> ACCAATATAGGTTTTGAAG
CTGATCCTAGTCGTAGAGC -> TGATCCTAGTCGTAGAGCC
GTAAGCTCTCCTGGTTTAA -> TAAGCTCTCCTGGTTTAAA
CGGCACTGGGACCTTCGGG -> GGCACTGGGACCTTCGGGG
AATAACGATGTTGAATTAG -> ATAACGATGTTGAATTAGC
AGTGACCCTCCGGCACTGG -> GTGACCCTCCGGCACTGGG
TACTCAGATCTCCAGGCAC -> ACTCAGATCTCCAGGCACA
CTAGTTTGTGACTGAACTT -> TAGTTTGTGACTGAACTTT
TACACTTGCTGGGTTAAGT -> ACACTTGCTGGGTTAAGTT
ACACTTGCTGGGTTAAGTT -> CACTTGCTGGGTTAAGTTC
ACTCCGAGTCCGCAGGGAC -> CTCCGAGTCCGCAGGGACC
GCACATACTGAATGGACGC -> CACATACTGAATGGACGCT
TAGAGCCTGTTAAGTGTTC -> AGAGCCTGTTAAGTGTTCC
AGAGCCTGTTAAGTGTTCC -> GAGCCTGTTAAGTGTTCCT
GCGGTGCGAAAAATGGTGG -> CGGTGCGAAAAATGGTGGA
TGTCAAACTATCATCCCTG -> GTCAAACTATCATCCCTGG
TATGCTTCGACGCTAGCTA -> ATGCTTCGACGCTAGCTAA
ATGCTTCGACGCTAGCTAA -> TGCTTCGACGCTAGCTAAG
CACCCAATTGACTCAGCAC -> ACCCAATTGACTCAGCACC
CGATACGCCTGTTGCAAAA -> GATACGCCTGTTGCAAAAC
TGCTCCGCGATCAACGATA -> GCTCCGCGATCAACGATAC
CGAGAACTCCGCGACGCCC -> GAGAACTCCGCGACGCCCC
AATGGTGGACCTCTCTTAC -> ATGGTGGACCTCTCTTACA
ACTCGGCACCACGGTAGTC -> CTCGGCACCACGGTAGTCG
ACTGTGCCGGTTACGCACA -> CTGTGCCGGTTACGCACAT
TAGTGAAGTTCTACCAATA -> AGTGAAGTTCTACCAATAG
AAAATATAACAATAAACCG -> AAATATAACAATAAACCGT
AAATATAACAATAAACCGT -> AATATAACAATAAACCGTA
AATGAACGACTCGGATAAA -> ATGAACGACTCGGATAAAA
CCATATTAGCCCTCGCCTG -> CATATTAGCCCTCGCCTGA
GGTACTCGCGAGCATCTTC -> GTACTCGCGAGCATCTTCT
GTACTCGCGAGCATCTTCT -> TACTCGCGAGCATCTTCTA
CTACTTAAACTATCATCCC -> TACTTAAACTATCATCCCT
ATATAAGTGACCCTCCGGC -> TATAAGTGACCCTCCGGCA
TATAACAATAAACCGTACC -> ATAACAATAAACCGTACCA
GGTTTTGAGAAGTTGGGAA -> GTTTTGAGAAGTTGGGAAT
CTAGCTGATCCCATCTCGC -> TAGCTGATCCCATCTCGCA
TAGCTGATCCCATCTCGCA -> AGCTGATCCCATCTCGCAT
CCCTCGCCTGAGCGCTTGA -> CCTCGCCTGAGCGCTTGAG
TTTTGAGAAGTTGGGAATA -> TTTGAGAAGTTGGGAATAC
TTTGAGAAGTTGGGAATAC -> TTGAGAAGTTGGGAATACT
GCGGCGGCATAGACCGTAA -> CGGCGGCATAGACCGTAAA
TCTTCAAGGCGAGTGACCT -> CTTCAAGGCGAGTGACCTT
ACTTTTGATGGTTGCTACT -> CTTTTGATGGTTGCTACTC
CTTTTGATGGTTGCTACTC -> TTTTGATGGTTGCTACTCT
TACTAGTTTGTGACTGAAC -> ACTAGTTTGTGACTGAACT
ACTAGTTTGTGACTGAACT -> CTAGTTTGTGACTGAACTT
CTCCTCGTATTCAAGCAAT -> TCCTCGTATTCAAGCAATG
TCCTCGTATTCAAGCAATG -> CCTCGTATTCAAGCAATGC
ACATACTGAATGGACGCTA -> CATACTGAATGGACGCTAG
CGAGTCCGCAGGGACCTTC -> GAGTCCGCAGGGACCTTCG
GAGTCCGCAGGGACCTTCG -> AGTCCGCAGGGACCTTCGA
CTTTAGTAATTCCGGATAC -> TTTAGTAATTCCGGATACT
CTCCACGAGTCTTGGGGAG -> TCCACGAGTCTTGGGGAGG
TCCACGAGTCTTGGGGAGG -> CCACGAGTCTTGGGGAGGT
TGACTCGCCCGTACGCCTT -> GACTCGCCCGTACGCCTTC
TTCACTGTGCCGGTTACGC -> TCACTGTGCCGGTTACGCA
GGACAAGCCTGAGTGCTTT -> GACAAGCCTGAGTGCTTTC
CTGTTGCAAAACATTGAAC -> TGTTGCAAAACATTGAACT
AACGATGTTGAATTAGCTC -> ACGATGTTGAATTAGCTCA
GCGATCTGCAACCCAGATA -> CGATCTGCAACCCAGATAT
AAAAACTAGCACGGACCTA -> AAAACTAGCACGGACCTAA
CCAGGACACACCCAATTGA -> CAGGACACACCCAATTGAC
CAGGGCTGGAGAATTTCTA -> AGGGCTGGAGAATTTCTAG
AGGGCTGGAGAATTTCTAG -> GGGCTGGAGAATTTCTAGC
TGGGACCTTCGGGGCATAT -> GGGACCTTCGGGGCATATT
CAGGCAGGGGATACCTGCG -> AGGCAGGGGATACCTGCGC
GTTTCGAGCCCAATAAAAA -> TTTCGAGCCCAATAAAAAC
ACCTCTCTTACACTGAAAA -> CCTCTCTTACACTGAAAAA
CCTCTCTTACACTGAAAAA -> CTCTCTTACACTGAAAAAT
AATACCTCCTCGTATTCAA -> ATACCTCCTCGTATTCAAG
CATATTACCAGCCTTGGAC -> ATATTACCAGCCTTGGACC
ACCCGCTGGCACGACTCAC -> CCCGCTGGCACGACTCACA
TCCTATCGGGATCCTGCCG -> CCTATCGGGATCCTGCCGT
CCTATCGGGATCCTGCCGT -> CTATCGGGATCCTGCCGTC
TCGCGAGCATCTTCTACTT -> CGCGAGCATCTTCTACTTA
GCAATTAGTTGTGTTCCGA -> CAATTAGTTGTGTTCCGAC
TGGGCTTGTCAAACTATCA -> GGGCTTGTCAAACTATCAT
TATACACTTGCTGGGTTAA -> ATACACTTGCTGGGTTAAG
ACCAACTAGCGATTCTGGT -> CCAACTAGCGATTCTGGTT
GAGCCTGTTAAGTGTTCCT -> AGCCTGTTAAGTGTTCCTT
CGGTCAACGACAAGTTACT -> GGTCAACGACAAGTTACTT
TTGTATTCCTCAAGCCGGG -> TGTATTCCTCAAGCCGGGA
GAACACTCGCAATTAGTTG -> AACACTCGCAATTAGTTGT
TAGCAGGCAGGGGATACCT -> AGCAGGCAGGGGATACCTG
AGCAATACACGGAGCCCCT -> GCAATACACGGAGCCCCTA
TGCCTGCTTGTCAACTACC -> GCCTGCTTGTCAACTACCA
TCAGATCTCCAGGCACACA -> CAGATCTCCAGGCACACAC
CACTTGCGAAGTAATACCT -> ACTTGCGAAGTAATACCTC
ACTTGCGAAGTAATACCTC -> CTTGCGAAGTAATACCTCC
AAGTTCTACTCCTCTTCAA -> AGTTCTACTCCTCTTCAAG
AGTTCTACTCCTCTTCAAG -> GTTCTACTCCTCTTCAAGG
CTACTCCTCTTCAAGGCGA -> TACTCCTCTTCAAGGCGAG
ACGATACGCCTGTTGCAAA -> CGATACGCCTGTTGCAAAA
AGTCCGCAGGGACCTTCGA -> GTCCGCAGGGACCTTCGAG
GTCCGCAGGGACCTTCGAG -> TCCGCAGGGACCTTCGAGA
CGCGAGTAGTTGTCTCCTC -> GCGAGTAGTTGTCTCCTCT
GGCAGGCAACATTTACGAA -> GCAGGCAACATTTACGAAA
TGCCTAAAAACTAGCACGG -> GCCTAAAAACTAGCACGGA
ACCCACGAAATGAGAAAAG -> CCCACGAAATGAGAAAAGC
ATCCCTGGTCCGAGTGCAA -> TCCCTGGTCCGAGTGCAAC
GTGAGAACATACGACAGCG -> TGAGAACATACGACAGCGG
GGATGCTGTTTGGCTGCGT -> GATGCTGTTTGGCTGCGTT
AATACACGGAGCCCCTAGG -> ATACACGGAGCCCCTAGGC
ATACACGGAGCCCCTAGGC -> TACACGGAGCCCCTAGGCG
CATCCACATCGCGGATAGG -> ATCCACATCGCGGATAGGC
ACATCTGTTACCGTAAGCT -> CATCTGTTACCGTAAGCTC
CATCTGTTACCGTAAGCTC -> ATCTGTTACCGTAAGCTCT
CACCACGGTAGTCGAACAC -> ACCACGGTAGTCGAACACT
ACCACGGTAGTCGAACACT -> CCACGGTAGTCGAACACTC
CTCGGTCGGGGAGTCCCCA -> TCGGTCGGGGAGTCCCCAG
GGCACTGCCTTATGCTTCG -> GCACTGCCTTATGCTTCGA
GCACTGCCTTATGCTTCGA -> CACTGCCTTATGCTTCGAC
ATGAGAAAAGCAGAATACA -> TGAGAAAAGCAGAATACAG
GTATAGTAATTCTGAGCAT -> TATAGTAATTCTGAGCATA
AACAAATATCTCTAGCTGA -> ACAAATATCTCTAGCTGAT
ACAAATATCTCTAGCTGAT -> CAAATATCTCTAGCTGATC
CCCACGAAATGAGAAAAGC -> CCACGAAATGAGAAAAGCA
GTATATTGCGACCTTCTAC -> TATATTGCGACCTTCTACT
CATAGCAATACACGGAGCC -> ATAGCAATACACGGAGCCC
TCCGTGCAGCTAGTGAAGT -> CCGTGCAGCTAGTGAAGTT
CCTGTCCCGCACGGCGTTC -> CTGTCCCGCACGGCGTTCC
GTTAAGTTCTACTCCTCTT -> TTAAGTTCTACTCCTCTTC
CCCTGACTCGCCCGTACGC -> CCTGACTCGCCCGTACGCC
ATACACTTGCTGGGTTAAG -> TACACTTGCTGGGTTAAGT
TGCGAAGTAATACCTCCTC -> GCGAAGTAATACCTCCTCG
TCTCCTCTTCTCTGATAAA -> CTCCTCTTCTCTGATAAAT
CTCCTCTTCTCTGATAAAT -> TCCTCTTCTCTGATAAATA
AGCAACGCACCCACGAAAT -> GCAACGCACCCACGAAATG
GCAACGCACCCACGAAATG -> CAACGCACCCACGAAATGA
CCTCTTCAAGGCGAGTGAC -> CTCTTCAAGGCGAGTGACC
CTCTTCAAGGCGAGTGACC -> TCTTCAAGGCGAGTGACCT
TATATAATGCACATCCACA -> ATATAATGCACATCCACAT
GTGAATCAAGCAGGGCTGG -> TGAATCAAGCAGGGCTGGA
CCCGATGCCCTGACTCGCC -> CCGATGCCCTGACTCGCCC
CGCGAGCATCTTCTACTTA -> GCGAGCATCTTCTACTTAA
TTTACTAGAGCAACGCACC -> TTACTAGAGCAACGCACCC
TAAGTGACCCTCCGGCACT -> AAGTGACCCTCCGGCACTG
AAGTGACCCTCCGGCACTG -> AGTGACCCTCCGGCACTGG
TACTCAAACGTCGAGTTAT -> ACTCAAACGTCGAGTTATC
CAAATTAATATGCACTTGC -> AAATTAATATGCACTTGCG
ATTACCAGCCTTGGACCAA -> TTACCAGCCTTGGACCAAG
CTAACGTGATACCAACTAG -> TAACGTGATACCAACTAGC
TAACGTGATACCAACTAGC -> AACGTGATACCAACTAGCG
CTGTTACCGTAAGCTCTCC -> TGTTACCGTAAGCTCTCCT
CCCTGGTCCCGTAAAGCAC -> CCTGGTCCCGTAAAGCACG
ATAGCAATACACGGAGCCC -> TAGCAATACACGGAGCCCC
CAGTATAATTCAGCTCCCT -> AGTATAATTCAGCTCCCTC
GATAAAATAACGATGTTGA -> ATAAAATAACGATGTTGAA
TCCCACCTGGTACTCGCGA -> CCCACCTGGTACTCGCGAG
CTCCTATCGGGATCCTGCC -> TCCTATCGGGATCCTGCCG
TTGGCCAGGACACACCCAA -> TGGCCAGGACACACCCAAT
TGGCCAGGACACACCCAAT -> GGCCAGGACACACCCAATT
CAACGCACCCACGAAATGA -> AACGCACCCACGAAATGAG
CAGCGGAGGCCTCCACGAG -> AGCGGAGGCCTCCACGAGT
TAAGATGTTTGACTAACGT -> AAGATGTTTGACTAACGTG
AAGATGTTTGACTAACGTG -> AGATGTTTGACTAACGTGA
TTGAGAAGTTGGGAATACT -> TGAGAAGTTGGGAATACTC
CCTTCGAGAACTCCGCGAC -> CTTCGAGAACTCCGCGACG
CTTCGAGAACTCCGCGACG -> TTCGAGAACTCCGCGACGC
AGCACGGACCGTGGGCTTG -> GCACGGACCGTGGGCTTGT
GCACGGACCGTGGGCTTGT -> CACGGACCGTGGGCTTGTC
TAGCGGCGGCATAGACCGT -> AGCGGCGGCATAGACCGTA
AGCGGCGGCATAGACCGTA -> GCGGCGGCATAGACCGTAA
GCGCGAGTAGTTGTCTCCT -> CGCGAGTAGTTGTCTCCTC
TCAATAGTACGCCTTTAGT -> CAATAGTACGCCTTTAGTA
CAATAGTACGCCTTTAGTA -> AATAGTACGCCTTTAGTAA
AGTGGCACTGCCTTATGCT -> GTGGCACTGCCTTATGCTT
TTTGGCTGCGTTGTATTCC -> TTGGCTGCGTTGTATTCCT
TTGGGAATACTCCGAGTCC -> TGGGAATACTCCGAGTCCG
ATGCTACAAACTATCATCC -> TGCTACAAACTATCATCCC
GCCTGTTAAGTGTTCCTTC -> CCTGTTAAGTGTTCCTTCG
CGCCTTCCGTGCAGCTAGT -> GCCTTCCGTGCAGCTAGTG
GCCTTCCGTGCAGCTAGTG -> CCTTCCGTGCAGCTAGTGA
TCAGCTCCCTCGCCTCGGT -> CAGCTCCCTCGCCTCGGTC
CAGCTCCCTCGCCTCGGTC -> AGCTCCCTCGCCTCGGTCG
CCGACCTTCCGGACTGCGC -> CGACCTTCCGGACTGCGCG
CGACCTTCCGGACTGCGCG -> GACCTTCCGGACTGCGCGA
GGATCCTGCCGTCCTCGTC -> GATCCTGCCGTCCTCGTCT
AATTTCTAGCGGTGCGAAA -> ATTTCTAGCGGTGCGAAAA
CGCTTACAAATTAATATGC -> GCTTACAAATTAATATGCA
ATAGACCGTAAAAACTAGC -> TAGACCGTAAAAACTAGCA
GCAATGCGTGTCCCACCTG -> CAATGCGTGTCCCACCTGG
CAATGCGTGTCCCACCTGG -> AATGCGTGTCCCACCTGGT
GATCCTGCCGTCCTCGTCT -> ATCCTGCCGTCCTCGTCTT
ATCCTGCCGTCCTCGTCTT -> TCCTGCCGTCCTCGTCTTG
ATATAGGTTTTGAAGGTGA -> TATAGGTTTTGAAGGTGAA
CGACCTTCAATAGTACGCC -> GACCTTCAATAGTACGCCT
CCCAGGCAGGCAACATTTA -> CCAGGCAGGCAACATTTAC
TATCATCCCTGGTCCCGCC -> ATCATCCCTGGTCCCGCCC
TCTGTTACCGTAAGCTCTC -> CTGTTACCGTAAGCTCTCC
TTTTGATGGTTGCTACTCT -> TTTGATGGTTGCTACTCTA
ACCTGTCCCGCACGGCGTT -> CCTGTCCCGCACGGCGTTC
AAGATAAGCCTACGGCGCC -> AGATAAGCCTACGGCGCCA
AGATAAGCCTACGGCGCCA -> GATAAGCCTACGGCGCCAC
AGTGTTCCTTCGCTAGCCG -> GTGTTCCTTCGCTAGCCGG
ATTAAACTATCATCCCTGG -> TTAAACTATCATCCCTGGT
TATGGTTTTAAAAACTAGC -> ATGGTTTTAAAAACTAGCA
ATGGTTTTAAAAACTAGCA -> TGGTTTTAAAAACTAGCAC
ATGTTTGACTAACGTGATA -> TGTTTGACTAACGTGATAC
GCCCCTAGGCGTAGGTTCA -> CCCCTAGGCGTAGGTTCAT
TATCATCCCTGGTCCCAGG -> ATCATCCCTGGTCCCAGGC
GACCTTCTACTCAGATCTC -> ACCTTCTACTCAGATCTCC
CCTTCCGTGCAGCTAGTGA -> CTTCCGTGCAGCTAGTGAA
ATCTCCAGGCACACACGCG -> TCTCCAGGCACACACGCGA
CACATCGCGGATAGGCGGG -> ACATCGCGGATAGGCGGGG
TCCTCTTCTCTGATAAATA -> CCTCTTCTCTGATAAATAA
TAAAATATAACAATAAACC -> AAAATATAACAATAAACCG
AAGTGTTCCTTCGCTAGCC -> AGTGTTCCTTCGCTAGCCG
ATGGTCACGTTCGGTCAAC -> TGGTCACGTTCGGTCAACG
GTGCCTAAAAACTAGCACG -> TGCCTAAAAACTAGCACGG
CTAGCGATTCTGGTTGAAC -> TAGCGATTCTGGTTGAACC
ACCGACTGTCTGCTCTATT -> CCGACTGTCTGCTCTATTT
CCGACTGTCTGCTCTATTT -> CGACTGTCTGCTCTATTTC
TCCGACCTTCCGGACTGCG -> CCGACCTTCCGGACTGCGC
ATCTGTTACCGTAAGCTCT -> TCTGTTACCGTAAGCTCTC
GATAAATAATCGATTGGGG -> ATAAATAATCGATTGGGGA
CGATTAAACTATCATCCCT -> GATTAAACTATCATCCCTG
GATTAAACTATCATCCCTG -> ATTAAACTATCATCCCTGG
GGGGAGGTTTCGAGCCCAA -> GGGAGGTTTCGAGCCCAAT
TAAGTGTTCCTTCGCTAGC -> AAGTGTTCCTTCGCTAGCC
TTAAGACATGACCAGTATA -> TAAGACATGACCAGTATAA
CGCTAGCCGGTAGTTAAGG -> GCTAGCCGGTAGTTAAGGT
GGTTGCTACTCTAACTAGC -> GTTGCTACTCTAACTAGCA
TCCCACGGGGGACAAGCCT -> CCCACGGGGGACAAGCCTG
GTACGCCTTCCGTGCAGCT -> TACGCCTTCCGTGCAGCTA
CCGTAAAAACTAGCACGGA -> CGTAAAAACTAGCACGGAC
AACATTTACGAAATAAGAT -> ACATTTACGAAATAAGATG
GGCCACTTCGCTGTACAAA -> GCCACTTCGCTGTACAAAG
TGACCTTGGAATGGTATGG -> GACCTTGGAATGGTATGGT
AGACCGTAAAAACTAGCAC -> GACCGTAAAAACTAGCACG
AGACTCCTATCGGGATCCT -> GACTCCTATCGGGATCCTG
AAATAATCGATTGGGGAGT -> AATAATCGATTGGGGAGTC
TAGTTGCGTAGGGGTATAT -> AGTTGCGTAGGGGTATATT
AGTTGCGTAGGGGTATATT -> GTTGCGTAGGGGTATATTG
TGCTTCGACGCTAGCTAAG -> GCTTCGACGCTAGCTAAGG
GGGGGTTGATGGGGGTGCT -> GGGGTTGATGGGGGTGCTG
GGGGTTGATGGGGGTGCTG -> GGGTTGATGGGGGTGCTGC
AACGTGATACCAACTAGCG -> ACGTGATACCAACTAGCGA
TGGAATACCTGTCCCGCAC -> GGAATACCTGTCCCGCACG
GGAATACCTGTCCCGCACG -> GAATACCTGTCCCGCACGG
GTCACGTTCGGTCAACGAC -> TCACGTTCGGTCAACGACA
ACTCAGCACCGACTGTCTG -> CTCAGCACCGACTGTCTGC
GAGGAGCCAGGAACTTAAC -> AGGAGCCAGGAACTTAACT
AAGAACAAATATCTCTAGC -> AGAACAAATATCTCTAGCT
CTGTTTGGCTGCGTTGTAT -> TGTTTGGCTGCGTTGTATT
GTGGCACTGCCTTATGCTT -> TGGCACTGCCTTATGCTTC
TGGCACTGCCTTATGCTTC -> GGCACTGCCTTATGCTTCG
CCACTGTCATACTGATCCT -> CACTGTCATACTGATCCTA
AGCGGATTGCCTGCTTGTC -> GCGGATTGCCTGCTTGTCA
GTGTCCCACCTGGTACTCG -> TGTCCCACCTGGTACTCGC
TAAATAATCGATTGGGGAG -> AAATAATCGATTGGGGAGT
TTCAATAGTACGCCTTTAG -> TCAATAGTACGCCTTTAGT
ACTAGCAGGCAGGGGATAC -> CTAGCAGGCAGGGGATACC
TAGCACGGACCGTGGGCTT -> AGCACGGACCGTGGGCTTG
GACTCGGATAAAATAACGA -> ACTCGGATAAAATAACGAT
GGGCATATTACCAGCCTTG -> GGCATATTACCAGCCTTGG
CATCCCACGGGGGACAAGC -> ATCCCACGGGGGACAAGCC
ATCCCACGGGGGACAAGCC -> TCCCACGGGGGACAAGCCT
ACCAATATAGGTTTTGAAG -> CCAATATAGGTTTTGAAGG
TCTCCAGGCACACACGCGA -> CTCCAGGCACACACGCGAT
AAAAACTAGCACGGACCCC -> AAAACTAGCACGGACCCCA
TGCGACCTTCTACTCAGAT -> GCGACCTTCTACTCAGATC
TAGCCTTTAATCATCACCC -> AGCCTTTAATCATCACCCC
AGTCTTGGGGAGGTTTCGA -> GTCTTGGGGAGGTTTCGAG
ATATTAGCCCTCGCCTGAG -> TATTAGCCCTCGCCTGAGC
CTACGGCGCCACCCAGCCA -> TACGGCGCCACCCAGCCAT
TACGGCGCCACCCAGCCAT -> ACGGCGCCACCCAGCCATG
CCTCCACGAGTCTTGGGGA -> CTCCACGAGTCTTGGGGAG
TAGCTAAGGTGACCAATAT -> AGCTAAGGTGACCAATATA
GTTTTGAGAAGTTGGGAAT -> TTTTGAGAAGTTGGGAATA
GCGTTCCCCGAGTGGCACT -> CGTTCCCCGAGTGGCACTG
CACATACTGAATGGACGCT -> ACATACTGAATGGACGCTA
CAAATATCTCTAGCTGATC -> AAATATCTCTAGCTGATCC
TTTATATAATGCACATCCA -> TTATATAATGCACATCCAC
TAAAAACTAGCACGGACCG -> AAAAACTAGCACGGACCGT
GCCTGCTTGTCAACTACCA -> CCTGCTTGTCAACTACCAT
TAGGCGGGGGGTTGATGGG -> AGGCGGGGGGTTGATGGGG
AGGCGGGGGGTTGATGGGG -> GGCGGGGGGTTGATGGGGG
ATAAATAATCGATTGGGGA -> TAAATAATCGATTGGGGAG
TCCTGCCGTCCTCGTCTTG -> CCTGCCGTCCTCGTCTTGA
GAGCATCTTCTACTTAAGA -> AGCATCTTCTACTTAAGAC
AGGCAGGGGATACCTGCGC -> GGCAGGGGATACCTGCGCA
TATGCACTTGCGAAGTAAT -> ATGCACTTGCGAAGTAATA
ATGCACTTGCGAAGTAATA -> TGCACTTGCGAAGTAATAC
CATCTTCTACTTAAGACAT -> ATCTTCTACTTAAGACATG
AAAGAACAAATATCTCTAG -> AAGAACAAATATCTCTAGC
GCGACCTTCTACTCAGATC -> CGACCTTCTACTCAGATCT
CTATCATCCCTGGTCCCGT -> TATCATCCCTGGTCCCGTA
ACTCGGATAAAATAACGAT -> CTCGGATAAAATAACGATG
TTCGCTGTACAAAGAACAA -> TCGCTGTACAAAGAACAAA
TCGCTGTACAAAGAACAAA -> CGCTGTACAAAGAACAAAT
AGTCGGCTGGGGATAACTA -> GTCGGCTGGGGATAACTAA
CAAGATAAGCCTACGGCGC -> AAGATAAGCCTACGGCGCC
GCGACCTTCAATAGTACGC -> CGACCTTCAATAGTACGCC
TTATGCTTCGACGCTAGCT -> TATGCTTCGACGCTAGCTA
AACATTGAACTCGGCACCA -> ACATTGAACTCGGCACCAC
ACGCCTTCCGTGCAGCTAG -> CGCCTTCCGTGCAGCTAGT
GATTGGGGAGTCTCTCATG -> ATTGGGGAGTCTCTCATGG
GCCCAATAAAAACTAGCAC -> CCCAATAAAAACTAGCACG
CTTCTACTTAAGACATGAC -> TTCTACTTAAGACATGACC
CGCGTACAAGATAAGCCTA -> GCGTACAAGATAAGCCTAC
CGCACGGCGTTCCCCGAGT -> GCACGGCGTTCCCCGAGTG
CCTCGTATTCAAGCAATGC -> CTCGTATTCAAGCAATGCG
AATCAAGCAGGGCTGGAGA -> ATCAAGCAGGGCTGGAGAA
CGGCGCCACCCAGCCATGG -> GGCGCCACCCAGCCATGGC
GTCAAACTATCATCCCTGG -> TCAAACTATCATCCCTGGT
TATCATCCCTGGTCCGAGT -> ATCATCCCTGGTCCGAGTG
AGCCCAATAAAAACTAGCA -> GCCCAATAAAAACTAGCAC
ACGGTAGTCGAACACTCGC -> CGGTAGTCGAACACTCGCA
CGACCTTCTACTCAGATCT -> GACCTTCTACTCAGATCTC
GAGAACTCCGCGACGCCCC -> AGAACTCCGCGACGCCCCG
AGAACTCCGCGACGCCCCG -> GAACTCCGCGACGCCCCGC
AGCAATGCGTGTCCCACCT -> GCAATGCGTGTCCCACCTG
GGCAGGGGATACCTGCGCA -> GCAGGGGATACCTGCGCAA
GCCGGTAGTTAAGGTGAGA -> CCGGTAGTTAAGGTGAGAA
CTTGCCATGTCGATTTATA -> TTGCCATGTCGATTTATAT
ACCAGCCTTGGACCAAGGT -> CCAGCCTTGGACCAAGGTC
TGTACAAAGAACAAATATC -> GTACAAAGAACAAATATCT
GTACAAAGAACAAATATCT -> TACAAAGAACAAATATCTC
AGCCTGTTAAGTGTTCCTT -> GCCTGTTAAGTGTTCCTTC
TTGGAATGGTATGGTTTTA -> TGGAATGGTATGGTTTTAA
CTCCGCGACGCCCCGCAAC -> TCCGCGACGCCCCGCAACC
TCCGCGACGCCCCGCAACC -> CCGCGACGCCCCGCAACCC
CCGAGTCCGCAGGGACCTT -> CGAGTCCGCAGGGACCTTC
GGGGTGCTGCTCCGCGATC -> GGGTGCTGCTCCGCGATCA
GGGTGCTGCTCCGCGATCA -> GGTGCTGCTCCGCGATCAA
AGCTGATCCCATCTCGCAT -> GCTGATCCCATCTCGCATG
TAAAGCACGTGCCTAAAAA -> AAAGCACGTGCCTAAAAAC
TTGAACCACTGTCATACTG -> TGAACCACTGTCATACTGA
TGAATCAAGCAGGGCTGGA -> GAATCAAGCAGGGCTGGAG
TACACGGAGCCCCTAGGCG -> ACACGGAGCCCCTAGGCGT
CTCGCATGGTCACGTTCGG -> TCGCATGGTCACGTTCGGT
GTAGGTTCATCCCACGGGG -> TAGGTTCATCCCACGGGGG
ACTCCGCGACGCCCCGCAA -> CTCCGCGACGCCCCGCAAC
AAACGACACGCGCTTACAA -> AACGACACGCGCTTACAAA
CCCTCCGGCACTGGGACCT -> CCTCCGGCACTGGGACCTT
AAGTTCTACCAATAGTTGC -> AGTTCTACCAATAGTTGCG
AACGACAAGTTACTTGTGA -> ACGACAAGTTACTTGTGAA
ATCATCCCTGGTCCCGCCC -> TCATCCCTGGTCCCGCCCG
CCAACTAGCGATTCTGGTT -> CAACTAGCGATTCTGGTTG
CGTCGAGTTATCCAAATCG -> GTCGAGTTATCCAAATCGC
ATCATCCCTGGTCCGAGTG -> TCATCCCTGGTCCGAGTGC
AGTCAATGAACGACTCGGA -> GTCAATGAACGACTCGGAT
ACGGCGCCACCCAGCCATG -> CGGCGCCACCCAGCCATGG
GGGTTGATGGGGGTGCTGC -> GGTTGATGGGGGTGCTGCT
GCGGATAGGCGGGGGGTTG -> CGGATAGGCGGGGGGTTGA
GGTCGGGGAGTCCCCAGTC -> GTCGGGGAGTCCCCAGTCA
TTAGCCCTCGCCTGAGCGC -> TAGCCCTCGCCTGAGCGCT
GCACGGCGTTCCCCGAGTG -> CACGGCGTTCCCCGAGTGG
CACGGCGTTCCCCGAGTGG -> ACGGCGTTCCCCGAGTGGC
TGTTTCCGAGGAGCCAGGA -> GTTTCCGAGGAGCCAGGAA
AGCTAAGGTGACCAATATA -> GCTAAGGTGACCAATATAG
GTCGTAGAGCCTGTTAAGT -> TCGTAGAGCCTGTTAAGTG
AGCATATAAGTGACCCTCC -> GCATATAAGTGACCCTCCG
TCCGCAGGGACCTTCGAGA -> CCGCAGGGACCTTCGAGAA
GCTAGCTTGCCATGTCGAT -> CTAGCTTGCCATGTCGATT
CTAGCTTGCCATGTCGATT -> TAGCTTGCCATGTCGATTT
CGCTGTACAAAGAACAAAT -> GCTGTACAAAGAACAAATA
CGCGGATAGGCGGGGGGTT -> GCGGATAGGCGGGGGGTTG
GCCGGTTACGCACATACTG -> CCGGTTACGCACATACTGA
CAACTTGTTTCCGAGGAGC -> AACTTGTTTCCGAGGAGCC
GAGCGGATTGCCTGCTTGT -> AGCGGATTGCCTGCTTGTC
CCGTGGGCTTGTCAAACTA -> CGTGGGCTTGTCAAACTAT
GGAGCGGATTGCCTGCTTG -> GAGCGGATTGCCTGCTTGT
CATATTAGCCCTCGCCTGA -> ATATTAGCCCTCGCCTGAG
TTAAAATATAACAATAAAC -> TAAAATATAACAATAAACC
GAGCATATAAGTGACCCTC -> AGCATATAAGTGACCCTCC
CTAGCAGGCAGGGGATACC -> TAGCAGGCAGGGGATACCT
AAGACATGACCAGTATAAT -> AGACATGACCAGTATAATT
AAATATCTCTAGCTGATCC -> AATATCTCTAGCTGATCCC
GCTGATCCCATCTCGCATG -> CTGATCCCATCTCGCATGG
TTGAACTCGGCACCACGGT -> TGAACTCGGCACCACGGTA
CTAGCCTTTAATCATCACC -> TAGCCTTTAATCATCACCC
CAACTAGCGATTCTGGTTG -> AACTAGCGATTCTGGTTGA
TCTAGCTGATCCCATCTCG -> CTAGCTGATCCCATCTCGC
TAAACCGTACCATATTAGC -> AAACCGTACCATATTAGCC
GAATCAAGCAGGGCTGGAG -> AATCAAGCAGGGCTGGAGA
AGCAGAATACAGATAACCC -> GCAGAATACAGATAACCCG
CAAACAAAGTTTGCAGCTT -> AAACAAAGTTTGCAGCTTA
AAACAAAGTTTGCAGCTTA -> AACAAAGTTTGCAGCTTAT
CTCGGATAAAATAACGATG -> TCGGATAAAATAACGATGT
CGCTTGAGAAGTTAGCGGC -> GCTTGAGAAGTTAGCGGCG
GGGGATAACTAATCATTTT -> GGGATAACTAATCATTTTA
TTCTACTTAAGACATGACC -> TCTACTTAAGACATGACCA
CACGGACCGTGGGCTTGTC -> ACGGACCGTGGGCTTGTCA
TAATTCAGCTCCCTCGCCT -> AATTCAGCTCCCTCGCCTC
AAGCAGAATACAGATAACC -> AGCAGAATACAGATAACCC
TGCCGGTTACGCACATACT -> GCCGGTTACGCACATACTG
TAAGACATGACCAGTATAA -> AAGACATGACCAGTATAAT
ACAAGATAAGCCTACGGCG -> CAAGATAAGCCTACGGCGC
AAAACTAGCACGGACCTAA -> AAACTAGCACGGACCTAAT
CTAGCACGGACCTAATATG -> TAGCACGGACCTAATATGC
CTGCTCCGCGATCAACGAT -> TGCTCCGCGATCAACGATA
GTAAAGCACGTGCCTAAAA -> TAAAGCACGTGCCTAAAAA
TAGCTTGCCATGTCGATTT -> AGCTTGCCATGTCGATTTA
GAATTTCTAGCGGTGCGAA -> AATTTCTAGCGGTGCGAAA
CATCCCTGGTCCCGTAAAG -> ATCCCTGGTCCCGTAAAGC
CTAATCATTTTACTAGAGC -> TAATCATTTTACTAGAGCA
AACAAAGTTTGCAGCTTAT -> ACAAAGTTTGCAGCTTATA
TAACAATAAACCGTACCAT -> AACAATAAACCGTACCATA
ATAAGATGTTTGACTAACG -> TAAGATGTTTGACTAACGT
TAATACCTCCTCGTATTCA -> AATACCTCCTCGTATTCAA
TAGCAATACACGGAGCCCC -> AGCAATACACGGAGCCCCT
TTATATAATGCACATCCAC -> TATATAATGCACATCCACA
CTAGTGAAGTTCTACCAAT -> TAGTGAAGTTCTACCAATA
TAGACCGTAAAAACTAGCA -> AGACCGTAAAAACTAGCAC
CCTGGTCCCAGGCAGGCAA -> CTGGTCCCAGGCAGGCAAC
ACCGTGGGCTTGTCAAACT -> CCGTGGGCTTGTCAAACTA
ATAACAATAAACCGTACCA -> TAACAATAAACCGTACCAT
CCCACCTGGTACTCGCGAG -> CCACCTGGTACTCGCGAGC
GACAAGCCTGAGTGCTTTC -> ACAAGCCTGAGTGCTTTCA
GCCCTCGCCTGAGCGCTTG -> CCCTCGCCTGAGCGCTTGA
GCACGGACCACGTTCCGAT -> CACGGACCACGTTCCGATT
CCGGTAGTTAAGGTGAGAA -> CGGTAGTTAAGGTGAGAAC
AATAAGATGTTTGACTAAC -> ATAAGATGTTTGACTAACG
GTATGGTTTTAAAAACTAG -> TATGGTTTTAAAAACTAGC
GATGCCCTGACTCGCCCGT -> ATGCCCTGACTCGCCCGTA
ATGCCCTGACTCGCCCGTA -> TGCCCTGACTCGCCCGTAC
AGCCTTGGACCAAGGTCGG -> GCCTTGGACCAAGGTCGGA
TACGCCTTCCGTGCAGCTA -> ACGCCTTCCGTGCAGCTAG
